,unique_tag,secondary_county_y,yr_range,year1,year2,n2_inflow,agi_inflow,n2_outflow,agi_outflow,n2_net,agi_net,arc_county,unique_tag2
1,Cherokee County-Cobb County-GA-1516,"Cobb County, GA",1516,2015,2016,4700,171360000,3129,88588000,1571,82772000,Cherokee County,Cherokee County-Cobb County-GA
2,Cherokee County-Fulton County-GA-1516,"Fulton County, GA",1516,2015,2016,2265,97119000,1216,57169000,1049,39950000,Cherokee County,Cherokee County-Fulton County-GA
3,Cherokee County-Gwinnett County-GA-1516,"Gwinnett County, GA",1516,2015,2016,658,19359000,401,10005000,257,9354000,Cherokee County,Cherokee County-Gwinnett County-GA
4,Cherokee County-Forsyth County-GA-1516,"Forsyth County, GA",1516,2015,2016,643,30139000,462,25906000,181,4233000,Cherokee County,Cherokee County-Forsyth County-GA
5,Cherokee County-DeKalb County-GA-1516,"DeKalb County, GA",1516,2015,2016,407,14257000,263,9434000,144,4823000,Cherokee County,Cherokee County-DeKalb County-GA
6,Cherokee County-Bartow County-GA-1516,"Bartow County, GA",1516,2015,2016,461,8917000,709,15448000,-248,-6531000,Cherokee County,Cherokee County-Bartow County-GA
7,Cherokee County-Pickens County-GA-1516,"Pickens County, GA",1516,2015,2016,413,8440000,683,14695000,-270,-6255000,Cherokee County,Cherokee County-Pickens County-GA
8,Cherokee County-Paulding County-GA-1516,"Paulding County, GA",1516,2015,2016,429,10901000,443,11085000,-14,-184000,Cherokee County,Cherokee County-Paulding County-GA
9,Cherokee County-Gilmer County-GA-1516,"Gilmer County, GA",1516,2015,2016,127,3133000,107,2916000,20,217000,Cherokee County,Cherokee County-Gilmer County-GA
10,Cherokee County-Douglas County-GA-1516,"Douglas County, GA",1516,2015,2016,143,3702000,76,1529000,67,2173000,Cherokee County,Cherokee County-Douglas County-GA
11,Cherokee County-Broward County-FL-1516,"Broward County, FL",1516,2015,2016,106,2817000,45,2402000,61,415000,Cherokee County,Cherokee County-Broward County-FL
12,Cherokee County-Henry County-GA-1516,"Henry County, GA",1516,2015,2016,85,2568000,59,1253000,26,1315000,Cherokee County,Cherokee County-Henry County-GA
13,Cherokee County-Palm Beach County-FL-1516,"Palm Beach County, FL",1516,2015,2016,61,1745000,36,1322000,25,423000,Cherokee County,Cherokee County-Palm Beach County-FL
14,Cherokee County-Hall County-GA-1516,"Hall County, GA",1516,2015,2016,55,1630000,118,3781000,-63,-2151000,Cherokee County,Cherokee County-Hall County-GA
15,Cherokee County-Hillsborough County-FL-1516,"Hillsborough County, FL",1516,2015,2016,67,2873000,78,1784000,-11,1089000,Cherokee County,Cherokee County-Hillsborough County-FL
16,Cherokee County-Gordon County-GA-1516,"Gordon County, GA",1516,2015,2016,58,683000,85,1708000,-27,-1025000,Cherokee County,Cherokee County-Gordon County-GA
17,Cherokee County-Chatham County-GA-1516,"Chatham County, GA",1516,2015,2016,69,2039000,31,708000,38,1331000,Cherokee County,Cherokee County-Chatham County-GA
18,Cherokee County-Floyd County-GA-1516,"Floyd County, GA",1516,2015,2016,56,1340000,94,3626000,-38,-2286000,Cherokee County,Cherokee County-Floyd County-GA
19,Cherokee County-Orange County-FL-1516,"Orange County, FL",1516,2015,2016,62,1171000,53,2065000,9,-894000,Cherokee County,Cherokee County-Orange County-FL
20,Cherokee County-Pinellas County-FL-1516,"Pinellas County, FL",1516,2015,2016,54,1600000,54,2216000,0,-616000,Cherokee County,Cherokee County-Pinellas County-FL
21,Cherokee County-Dawson County-GA-1516,"Dawson County, GA",1516,2015,2016,65,1236000,91,2448000,-26,-1212000,Cherokee County,Cherokee County-Dawson County-GA
22,Cherokee County-Maricopa County-AZ-1516,"Maricopa County, AZ",1516,2015,2016,57,1947000,61,1465000,-4,482000,Cherokee County,Cherokee County-Maricopa County-AZ
23,Cherokee County-Carroll County-GA-1516,"Carroll County, GA",1516,2015,2016,50,1299000,64,1024000,-14,275000,Cherokee County,Cherokee County-Carroll County-GA
24,Cherokee County-Clarke County-GA-1516,"Clarke County, GA",1516,2015,2016,40,830000,41,932000,-1,-102000,Cherokee County,Cherokee County-Clarke County-GA
25,Cherokee County-Duval County-FL-1516,"Duval County, FL",1516,2015,2016,40,908000,63,1832000,-23,-924000,Cherokee County,Cherokee County-Duval County-FL
26,Cherokee County-Hamilton County-TN-1516,"Hamilton County, TN",1516,2015,2016,40,1100000,37,1484000,3,-384000,Cherokee County,Cherokee County-Hamilton County-TN
27,Cherokee County-Harris County-TX-1516,"Harris County, TX",1516,2015,2016,46,1680000,59,1408000,-13,272000,Cherokee County,Cherokee County-Harris County-TX
29,Clayton County-Fulton County-GA-1516,"Fulton County, GA",1516,2015,2016,7117,76405000,5871,75446000,1246,959000,Clayton County,Clayton County-Fulton County-GA
30,Clayton County-DeKalb County-GA-1516,"DeKalb County, GA",1516,2015,2016,3241,37714000,2484,31376000,757,6338000,Clayton County,Clayton County-DeKalb County-GA
31,Clayton County-Henry County-GA-1516,"Henry County, GA",1516,2015,2016,2704,38398000,4215,68038000,-1511,-29640000,Clayton County,Clayton County-Henry County-GA
32,Clayton County-Cobb County-GA-1516,"Cobb County, GA",1516,2015,2016,970,11474000,860,13583000,110,-2109000,Clayton County,Clayton County-Cobb County-GA
33,Clayton County-Gwinnett County-GA-1516,"Gwinnett County, GA",1516,2015,2016,812,10862000,907,12721000,-95,-1859000,Clayton County,Clayton County-Gwinnett County-GA
34,Clayton County-Fayette County-GA-1516,"Fayette County, GA",1516,2015,2016,510,7866000,951,21455000,-441,-13589000,Clayton County,Clayton County-Fayette County-GA
35,Clayton County-Travis County-TX-1516,"Travis County, TX",1516,2015,2016,410,3496000,90,848000,320,2648000,Clayton County,Clayton County-Travis County-TX
36,Clayton County-Spalding County-GA-1516,"Spalding County, GA",1516,2015,2016,323,3461000,480,5670000,-157,-2209000,Clayton County,Clayton County-Spalding County-GA
37,Clayton County-Douglas County-GA-1516,"Douglas County, GA",1516,2015,2016,259,3897000,280,4058000,-21,-161000,Clayton County,Clayton County-Douglas County-GA
38,Clayton County-Miami-Dade County-FL-1516,"Miami-Dade County, FL",1516,2015,2016,217,3326000,111,1026000,106,2300000,Clayton County,Clayton County-Miami-Dade County-FL
39,Clayton County-Rockdale County-GA-1516,"Rockdale County, GA",1516,2015,2016,203,2603000,247,3444000,-44,-841000,Clayton County,Clayton County-Rockdale County-GA
40,Clayton County-Coweta County-GA-1516,"Coweta County, GA",1516,2015,2016,196,2307000,267,4700000,-71,-2393000,Clayton County,Clayton County-Coweta County-GA
41,Clayton County-Muscogee County-GA-1516,"Muscogee County, GA",1516,2015,2016,181,2261000,80,779000,101,1482000,Clayton County,Clayton County-Muscogee County-GA
42,Clayton County-Kings County-NY-1516,"Kings County, NY",1516,2015,2016,159,1679000,61,672000,98,1007000,Clayton County,Clayton County-Kings County-NY
43,Clayton County-Cook County-IL-1516,"Cook County, IL",1516,2015,2016,163,1688000,97,1174000,66,514000,Clayton County,Clayton County-Cook County-IL
44,Clayton County-Bibb County-GA-1516,"Bibb County, GA",1516,2015,2016,159,1457000,126,1178000,33,279000,Clayton County,Clayton County-Bibb County-GA
45,Clayton County-Los Angeles County-CA-1516,"Los Angeles County, CA",1516,2015,2016,132,2131000,50,923000,82,1208000,Clayton County,Clayton County-Los Angeles County-CA
46,Clayton County-Broward County-FL-1516,"Broward County, FL",1516,2015,2016,149,1858000,92,944000,57,914000,Clayton County,Clayton County-Broward County-FL
47,Clayton County-Newton County-GA-1516,"Newton County, GA",1516,2015,2016,132,1558000,221,3643000,-89,-2085000,Clayton County,Clayton County-Newton County-GA
48,Clayton County-Orange County-FL-1516,"Orange County, FL",1516,2015,2016,122,1198000,74,1141000,48,57000,Clayton County,Clayton County-Orange County-FL
49,Clayton County-Chatham County-GA-1516,"Chatham County, GA",1516,2015,2016,119,1470000,81,1078000,38,392000,Clayton County,Clayton County-Chatham County-GA
50,Clayton County-Shelby County-TN-1516,"Shelby County, TN",1516,2015,2016,106,1408000,47,639000,59,769000,Clayton County,Clayton County-Shelby County-TN
51,Clayton County-Richmond County-GA-1516,"Richmond County, GA",1516,2015,2016,94,965000,58,849000,36,116000,Clayton County,Clayton County-Richmond County-GA
52,Clayton County-Wayne County-MI-1516,"Wayne County, MI",1516,2015,2016,115,1028000,55,389000,60,639000,Clayton County,Clayton County-Wayne County-MI
53,Clayton County-Harris County-TX-1516,"Harris County, TX",1516,2015,2016,92,1164000,108,1436000,-16,-272000,Clayton County,Clayton County-Harris County-TX
54,Clayton County-Duval County-FL-1516,"Duval County, FL",1516,2015,2016,111,904000,90,1194000,21,-290000,Clayton County,Clayton County-Duval County-FL
55,Clayton County-Dougherty County-GA-1516,"Dougherty County, GA",1516,2015,2016,88,1105000,68,445000,20,660000,Clayton County,Clayton County-Dougherty County-GA
56,Clayton County-Houston County-GA-1516,"Houston County, GA",1516,2015,2016,100,894000,77,713000,23,181000,Clayton County,Clayton County-Houston County-GA
57,Clayton County-Hillsborough County-FL-1516,"Hillsborough County, FL",1516,2015,2016,82,1057000,81,1127000,1,-70000,Clayton County,Clayton County-Hillsborough County-FL
58,Clayton County-Paulding County-GA-1516,"Paulding County, GA",1516,2015,2016,68,896000,88,1053000,-20,-157000,Clayton County,Clayton County-Paulding County-GA
59,Clayton County-Mecklenburg County-NC-1516,"Mecklenburg County, NC",1516,2015,2016,65,898000,71,2156000,-6,-1258000,Clayton County,Clayton County-Mecklenburg County-NC
60,Clayton County-Carroll County-GA-1516,"Carroll County, GA",1516,2015,2016,54,856000,80,1281000,-26,-425000,Clayton County,Clayton County-Carroll County-GA
61,Clayton County-Prince George's County-MD-1516,"Prince George's County, MD",1516,2015,2016,53,802000,32,609000,21,193000,Clayton County,Clayton County-Prince George's County-MD
62,Clayton County-Davidson County-TN-1516,"Davidson County, TN",1516,2015,2016,56,660000,34,574000,22,86000,Clayton County,Clayton County-Davidson County-TN
63,Clayton County-Butts County-GA-1516,"Butts County, GA",1516,2015,2016,57,832000,92,1406000,-35,-574000,Clayton County,Clayton County-Butts County-GA
64,Clayton County-Maricopa County-AZ-1516,"Maricopa County, AZ",1516,2015,2016,48,497000,51,149000,-3,348000,Clayton County,Clayton County-Maricopa County-AZ
65,Clayton County-Tarrant County-TX-1516,"Tarrant County, TX",1516,2015,2016,51,498000,45,561000,6,-63000,Clayton County,Clayton County-Tarrant County-TX
67,Cobb County-Fulton County-GA-1516,"Fulton County, GA",1516,2015,2016,8892,349591000,8487,394280000,405,-44689000,Cobb County,Cobb County-Fulton County-GA
68,Cobb County-DeKalb County-GA-1516,"DeKalb County, GA",1516,2015,2016,3608,123557000,3199,115260000,409,8297000,Cobb County,Cobb County-DeKalb County-GA
69,Cobb County-Cherokee County-GA-1516,"Cherokee County, GA",1516,2015,2016,3129,88588000,4700,171360000,-1571,-82772000,Cobb County,Cobb County-Cherokee County-GA
70,Cobb County-Gwinnett County-GA-1516,"Gwinnett County, GA",1516,2015,2016,2223,58390000,2418,58574000,-195,-184000,Cobb County,Cobb County-Gwinnett County-GA
71,Cobb County-Paulding County-GA-1516,"Paulding County, GA",1516,2015,2016,2511,64696000,4288,97882000,-1777,-33186000,Cobb County,Cobb County-Paulding County-GA
72,Cobb County-Douglas County-GA-1516,"Douglas County, GA",1516,2015,2016,2071,41114000,2820,42738000,-749,-1624000,Cobb County,Cobb County-Douglas County-GA
73,Cobb County-Clayton County-GA-1516,"Clayton County, GA",1516,2015,2016,860,13583000,970,11474000,-110,2109000,Cobb County,Cobb County-Clayton County-GA
74,Cobb County-Bartow County-GA-1516,"Bartow County, GA",1516,2015,2016,739,15580000,1133,25771000,-394,-10191000,Cobb County,Cobb County-Bartow County-GA
75,Cobb County-Henry County-GA-1516,"Henry County, GA",1516,2015,2016,520,14003000,343,6763000,177,7240000,Cobb County,Cobb County-Henry County-GA
76,Cobb County-Cook County-IL-1516,"Cook County, IL",1516,2015,2016,503,15900000,231,8845000,272,7055000,Cobb County,Cobb County-Cook County-IL
77,Cobb County-Los Angeles County-CA-1516,"Los Angeles County, CA",1516,2015,2016,404,11429000,288,13671000,116,-2242000,Cobb County,Cobb County-Los Angeles County-CA
78,Cobb County-Forsyth County-GA-1516,"Forsyth County, GA",1516,2015,2016,355,13789000,936,41457000,-581,-27668000,Cobb County,Cobb County-Forsyth County-GA
79,Cobb County-Broward County-FL-1516,"Broward County, FL",1516,2015,2016,359,9186000,250,9352000,109,-166000,Cobb County,Cobb County-Broward County-FL
80,Cobb County-Travis County-TX-1516,"Travis County, TX",1516,2015,2016,367,7198000,217,7738000,150,-540000,Cobb County,Cobb County-Travis County-TX
81,Cobb County-Miami-Dade County-FL-1516,"Miami-Dade County, FL",1516,2015,2016,352,7783000,182,4183000,170,3600000,Cobb County,Cobb County-Miami-Dade County-FL
82,Cobb County-Orange County-FL-1516,"Orange County, FL",1516,2015,2016,307,8056000,220,8211000,87,-155000,Cobb County,Cobb County-Orange County-FL
83,Cobb County-Carroll County-GA-1516,"Carroll County, GA",1516,2015,2016,336,6858000,329,5850000,7,1008000,Cobb County,Cobb County-Carroll County-GA
84,Cobb County-Chatham County-GA-1516,"Chatham County, GA",1516,2015,2016,268,7290000,163,6480000,105,810000,Cobb County,Cobb County-Chatham County-GA
85,Cobb County-Fayette County-GA-1516,"Fayette County, GA",1516,2015,2016,259,10559000,280,9904000,-21,655000,Cobb County,Cobb County-Fayette County-GA
86,Cobb County-Mecklenburg County-NC-1516,"Mecklenburg County, NC",1516,2015,2016,262,9373000,257,10440000,5,-1067000,Cobb County,Cobb County-Mecklenburg County-NC
87,Cobb County-Hillsborough County-FL-1516,"Hillsborough County, FL",1516,2015,2016,263,8652000,344,12309000,-81,-3657000,Cobb County,Cobb County-Hillsborough County-FL
88,Cobb County-Coweta County-GA-1516,"Coweta County, GA",1516,2015,2016,253,16587000,240,7182000,13,9405000,Cobb County,Cobb County-Coweta County-GA
89,Cobb County-Jefferson County-AL-1516,"Jefferson County, AL",1516,2015,2016,255,6923000,164,5335000,91,1588000,Cobb County,Cobb County-Jefferson County-AL
90,Cobb County-Palm Beach County-FL-1516,"Palm Beach County, FL",1516,2015,2016,244,7912000,174,6902000,70,1010000,Cobb County,Cobb County-Palm Beach County-FL
91,Cobb County-Duval County-FL-1516,"Duval County, FL",1516,2015,2016,225,5861000,253,7105000,-28,-1244000,Cobb County,Cobb County-Duval County-FL
92,Cobb County-Muscogee County-GA-1516,"Muscogee County, GA",1516,2015,2016,236,5594000,132,2493000,104,3101000,Cobb County,Cobb County-Muscogee County-GA
93,Cobb County-Harris County-TX-1516,"Harris County, TX",1516,2015,2016,253,8236000,284,9762000,-31,-1526000,Cobb County,Cobb County-Harris County-TX
94,Cobb County-Kings County-NY-1516,"Kings County, NY",1516,2015,2016,215,4472000,76,3184000,139,1288000,Cobb County,Cobb County-Kings County-NY
95,Cobb County-Shelby County-TN-1516,"Shelby County, TN",1516,2015,2016,207,6250000,98,3007000,109,3243000,Cobb County,Cobb County-Shelby County-TN
96,Cobb County-Clarke County-GA-1516,"Clarke County, GA",1516,2015,2016,144,3044000,126,3155000,18,-111000,Cobb County,Cobb County-Clarke County-GA
97,Cobb County-Davidson County-TN-1516,"Davidson County, TN",1516,2015,2016,161,4522000,159,5460000,2,-938000,Cobb County,Cobb County-Davidson County-TN
98,Cobb County-Bibb County-GA-1516,"Bibb County, GA",1516,2015,2016,177,4806000,109,2265000,68,2541000,Cobb County,Cobb County-Bibb County-GA
99,Cobb County-Rockdale County-GA-1516,"Rockdale County, GA",1516,2015,2016,179,4065000,149,2985000,30,1080000,Cobb County,Cobb County-Rockdale County-GA
100,Cobb County-Queens County-NY-1516,"Queens County, NY",1516,2015,2016,183,5000000,56,1516000,127,3484000,Cobb County,Cobb County-Queens County-NY
101,Cobb County-Dallas County-TX-1516,"Dallas County, TX",1516,2015,2016,170,6773000,223,16015000,-53,-9242000,Cobb County,Cobb County-Dallas County-TX
102,Cobb County-Maricopa County-AZ-1516,"Maricopa County, AZ",1516,2015,2016,194,6740000,240,8227000,-46,-1487000,Cobb County,Cobb County-Maricopa County-AZ
103,Cobb County-Hall County-GA-1516,"Hall County, GA",1516,2015,2016,144,4559000,181,7666000,-37,-3107000,Cobb County,Cobb County-Hall County-GA
104,Cobb County-Floyd County-GA-1516,"Floyd County, GA",1516,2015,2016,163,3929000,166,3923000,-3,6000,Cobb County,Cobb County-Floyd County-GA
105,Cobb County-San Diego County-CA-1516,"San Diego County, CA",1516,2015,2016,153,4404000,154,4372000,-1,32000,Cobb County,Cobb County-San Diego County-CA
106,Cobb County-Wake County-NC-1516,"Wake County, NC",1516,2015,2016,165,5997000,187,8129000,-22,-2132000,Cobb County,Cobb County-Wake County-NC
107,Cobb County-Greenville County-SC-1516,"Greenville County, SC",1516,2015,2016,144,5156000,141,5907000,3,-751000,Cobb County,Cobb County-Greenville County-SC
108,Cobb County-Newton County-GA-1516,"Newton County, GA",1516,2015,2016,146,3441000,128,2417000,18,1024000,Cobb County,Cobb County-Newton County-GA
109,Cobb County-Leon County-FL-1516,"Leon County, FL",1516,2015,2016,130,3467000,49,1627000,81,1840000,Cobb County,Cobb County-Leon County-FL
110,Cobb County-Tarrant County-TX-1516,"Tarrant County, TX",1516,2015,2016,152,6414000,201,7438000,-49,-1024000,Cobb County,Cobb County-Tarrant County-TX
111,Cobb County-Clark County-NV-1516,"Clark County, NV",1516,2015,2016,139,3107000,111,3758000,28,-651000,Cobb County,Cobb County-Clark County-NV
112,Cobb County-Wayne County-MI-1516,"Wayne County, MI",1516,2015,2016,130,3127000,93,1164000,37,1963000,Cobb County,Cobb County-Wayne County-MI
113,Cobb County-Richmond County-GA-1516,"Richmond County, GA",1516,2015,2016,117,2916000,93,1361000,24,1555000,Cobb County,Cobb County-Richmond County-GA
114,Cobb County-Bronx County-NY-1516,"Bronx County, NY",1516,2015,2016,114,1681000,35,352000,79,1329000,Cobb County,Cobb County-Bronx County-NY
115,Cobb County-Pinellas County-FL-1516,"Pinellas County, FL",1516,2015,2016,128,3709000,173,7022000,-45,-3313000,Cobb County,Cobb County-Pinellas County-FL
116,Cobb County-Houston County-GA-1516,"Houston County, GA",1516,2015,2016,123,3793000,102,2567000,21,1226000,Cobb County,Cobb County-Houston County-GA
117,Cobb County-Hamilton County-TN-1516,"Hamilton County, TN",1516,2015,2016,119,6789000,164,6940000,-45,-151000,Cobb County,Cobb County-Hamilton County-TN
118,Cobb County-Essex County-NJ-1516,"Essex County, NJ",1516,2015,2016,141,3937000,33,911000,108,3026000,Cobb County,Cobb County-Essex County-NJ
119,Cobb County-St. Louis County-MO-1516,"St. Louis County, MO",1516,2015,2016,116,4288000,50,2282000,66,2006000,Cobb County,Cobb County-St. Louis County-MO
120,Cobb County-Fairfax County-VA-1516,"Fairfax County, VA",1516,2015,2016,141,6856000,107,5583000,34,1273000,Cobb County,Cobb County-Fairfax County-VA
121,Cobb County-Lowndes County-GA-1516,"Lowndes County, GA",1516,2015,2016,102,1744000,47,537000,55,1207000,Cobb County,Cobb County-Lowndes County-GA
122,Cobb County-Richland County-SC-1516,"Richland County, SC",1516,2015,2016,117,3353000,53,1526000,64,1827000,Cobb County,Cobb County-Richland County-SC
123,Cobb County-Philadelphia County-PA-1516,"Philadelphia County, PA",1516,2015,2016,110,3033000,37,843000,73,2190000,Cobb County,Cobb County-Philadelphia County-PA
124,Cobb County-New York County-NY-1516,"New York County, NY",1516,2015,2016,91,5335000,102,6678000,-11,-1343000,Cobb County,Cobb County-New York County-NY
125,Cobb County-Franklin County-OH-1516,"Franklin County, OH",1516,2015,2016,119,3424000,95,2938000,24,486000,Cobb County,Cobb County-Franklin County-OH
126,Cobb County-Marion County-IN-1516,"Marion County, IN",1516,2015,2016,93,2744000,50,730000,43,2014000,Cobb County,Cobb County-Marion County-IN
127,Cobb County-Prince George's County-MD-1516,"Prince George's County, MD",1516,2015,2016,120,2636000,62,1205000,58,1431000,Cobb County,Cobb County-Prince George's County-MD
128,Cobb County-King County-WA-1516,"King County, WA",1516,2015,2016,103,5383000,199,11674000,-96,-6291000,Cobb County,Cobb County-King County-WA
129,Cobb County-Charleston County-SC-1516,"Charleston County, SC",1516,2015,2016,90,3295000,103,4651000,-13,-1356000,Cobb County,Cobb County-Charleston County-SC
130,Cobb County-Montgomery County-AL-1516,"Montgomery County, AL",1516,2015,2016,92,3119000,57,1193000,35,1926000,Cobb County,Cobb County-Montgomery County-AL
131,Cobb County-Cuyahoga County-OH-1516,"Cuyahoga County, OH",1516,2015,2016,92,1932000,83,1743000,9,189000,Cobb County,Cobb County-Cuyahoga County-OH
132,Cobb County-Knox County-TN-1516,"Knox County, TN",1516,2015,2016,99,2700000,63,1996000,36,704000,Cobb County,Cobb County-Knox County-TN
133,Cobb County-Orange County-CA-1516,"Orange County, CA",1516,2015,2016,122,6205000,93,3221000,29,2984000,Cobb County,Cobb County-Orange County-CA
134,Cobb County-Bulloch County-GA-1516,"Bulloch County, GA",1516,2015,2016,68,1329000,41,1300000,27,29000,Cobb County,Cobb County-Bulloch County-GA
135,Cobb County-Gordon County-GA-1516,"Gordon County, GA",1516,2015,2016,81,1845000,85,2856000,-4,-1011000,Cobb County,Cobb County-Gordon County-GA
136,Cobb County-Oakland County-MI-1516,"Oakland County, MI",1516,2015,2016,99,3353000,91,3779000,8,-426000,Cobb County,Cobb County-Oakland County-MI
137,Cobb County-Milwaukee County-WI-1516,"Milwaukee County, WI",1516,2015,2016,117,2413000,36,2773000,81,-360000,Cobb County,Cobb County-Milwaukee County-WI
138,Cobb County-Madison County-AL-1516,"Madison County, AL",1516,2015,2016,89,3080000,80,3082000,9,-2000,Cobb County,Cobb County-Madison County-AL
139,Cobb County-Dougherty County-GA-1516,"Dougherty County, GA",1516,2015,2016,85,1709000,58,1538000,27,171000,Cobb County,Cobb County-Dougherty County-GA
140,Cobb County-Montgomery County-MD-1516,"Montgomery County, MD",1516,2015,2016,85,4730000,121,4684000,-36,46000,Cobb County,Cobb County-Montgomery County-MD
141,Cobb County-Guilford County-NC-1516,"Guilford County, NC",1516,2015,2016,83,2322000,66,2781000,17,-459000,Cobb County,Cobb County-Guilford County-NC
142,Cobb County-Middlesex County-MA-1516,"Middlesex County, MA",1516,2015,2016,110,4827000,52,3894000,58,933000,Cobb County,Cobb County-Middlesex County-MA
143,Cobb County-Suffolk County-NY-1516,"Suffolk County, NY",1516,2015,2016,85,2122000,43,869000,42,1253000,Cobb County,Cobb County-Suffolk County-NY
144,Cobb County-Hamilton County-OH-1516,"Hamilton County, OH",1516,2015,2016,88,3271000,40,864000,48,2407000,Cobb County,Cobb County-Hamilton County-OH
145,Cobb County-Allegheny County-PA-1516,"Allegheny County, PA",1516,2015,2016,97,3794000,85,3428000,12,366000,Cobb County,Cobb County-Allegheny County-PA
146,Cobb County-Shelby County-AL-1516,"Shelby County, AL",1516,2015,2016,93,4514000,43,1854000,50,2660000,Cobb County,Cobb County-Shelby County-AL
147,Cobb County-Seminole County-FL-1516,"Seminole County, FL",1516,2015,2016,96,3946000,82,2948000,14,998000,Cobb County,Cobb County-Seminole County-FL
148,Cobb County-Bexar County-TX-1516,"Bexar County, TX",1516,2015,2016,85,2912000,111,3259000,-26,-347000,Cobb County,Cobb County-Bexar County-TX
149,Cobb County-Lee County-FL-1516,"Lee County, FL",1516,2015,2016,86,2090000,82,4266000,4,-2176000,Cobb County,Cobb County-Lee County-FL
150,Cobb County-Polk County-GA-1516,"Polk County, GA",1516,2015,2016,82,1454000,101,1955000,-19,-501000,Cobb County,Cobb County-Polk County-GA
151,Cobb County-Collin County-TX-1516,"Collin County, TX",1516,2015,2016,95,3408000,117,5056000,-22,-1648000,Cobb County,Cobb County-Collin County-TX
152,Cobb County-Santa Clara County-CA-1516,"Santa Clara County, CA",1516,2015,2016,86,5157000,96,7645000,-10,-2488000,Cobb County,Cobb County-Santa Clara County-CA
153,Cobb County-Pickens County-GA-1516,"Pickens County, GA",1516,2015,2016,73,2642000,138,8266000,-65,-5624000,Cobb County,Cobb County-Pickens County-GA
154,Cobb County-Hennepin County-MN-1516,"Hennepin County, MN",1516,2015,2016,81,4242000,68,4110000,13,132000,Cobb County,Cobb County-Hennepin County-MN
155,Cobb County-Columbia County-GA-1516,"Columbia County, GA",1516,2015,2016,82,4088000,96,3228000,-14,860000,Cobb County,Cobb County-Columbia County-GA
156,Cobb County-Orleans Parish-LA-1516,"Orleans Parish, LA",1516,2015,2016,71,1351000,68,1074000,3,277000,Cobb County,Cobb County-Orleans Parish-LA
157,Cobb County-Lee County-AL-1516,"Lee County, AL",1516,2015,2016,69,1902000,50,1280000,19,622000,Cobb County,Cobb County-Lee County-AL
158,Cobb County-Hartford County-CT-1516,"Hartford County, CT",1516,2015,2016,77,2955000,53,1782000,24,1173000,Cobb County,Cobb County-Hartford County-CT
159,Cobb County-Walton County-GA-1516,"Walton County, GA",1516,2015,2016,60,1815000,77,1622000,-17,193000,Cobb County,Cobb County-Walton County-GA
160,Cobb County-East Baton Rouge Parish-LA-1516,"East Baton Rouge Parish, LA",1516,2015,2016,76,2015000,41,683000,35,1332000,Cobb County,Cobb County-East Baton Rouge Parish-LA
161,Cobb County-St. Johns County-FL-1516,"St. Johns County, FL",1516,2015,2016,91,5738000,105,7832000,-14,-2094000,Cobb County,Cobb County-St. Johns County-FL
162,Cobb County-Volusia County-FL-1516,"Volusia County, FL",1516,2015,2016,68,1216000,80,2047000,-12,-831000,Cobb County,Cobb County-Volusia County-FL
163,Cobb County-DuPage County-IL-1516,"DuPage County, IL",1516,2015,2016,100,7516000,59,2400000,41,5116000,Cobb County,Cobb County-DuPage County-IL
164,Cobb County-Virginia Beach city-VA-1516,"Virginia Beach city, VA",1516,2015,2016,92,2624000,43,762000,49,1862000,Cobb County,Cobb County-Virginia Beach city-VA
165,Cobb County-Mobile County-AL-1516,"Mobile County, AL",1516,2015,2016,66,1220000,68,1207000,-2,13000,Cobb County,Cobb County-Mobile County-AL
166,Cobb County-Fairfield County-CT-1516,"Fairfield County, CT",1516,2015,2016,71,4389000,44,2452000,27,1937000,Cobb County,Cobb County-Fairfield County-CT
167,Cobb County-Whitfield County-GA-1516,"Whitfield County, GA",1516,2015,2016,68,1998000,84,1452000,-16,546000,Cobb County,Cobb County-Whitfield County-GA
168,Cobb County-Bergen County-NJ-1516,"Bergen County, NJ",1516,2015,2016,87,6175000,42,2299000,45,3876000,Cobb County,Cobb County-Bergen County-NJ
169,Cobb County-Arapahoe County-CO-1516,"Arapahoe County, CO",1516,2015,2016,85,2328000,48,1686000,37,642000,Cobb County,Cobb County-Arapahoe County-CO
170,Cobb County-District of Columbia-DC-1516,"District of Columbia, DC",1516,2015,2016,59,2398000,62,3169000,-3,-771000,Cobb County,Cobb County-District of Columbia-DC
171,Cobb County-Pasco County-FL-1516,"Pasco County, FL",1516,2015,2016,76,3551000,64,1171000,12,2380000,Cobb County,Cobb County-Pasco County-FL
172,Cobb County-Alameda County-CA-1516,"Alameda County, CA",1516,2015,2016,55,1949000,71,3877000,-16,-1928000,Cobb County,Cobb County-Alameda County-CA
173,Cobb County-Denver County-CO-1516,"Denver County, CO",1516,2015,2016,57,2175000,88,4879000,-31,-2704000,Cobb County,Cobb County-Denver County-CO
174,Cobb County-Buncombe County-NC-1516,"Buncombe County, NC",1516,2015,2016,54,1752000,57,2335000,-3,-583000,Cobb County,Cobb County-Buncombe County-NC
175,Cobb County-Cumberland County-NC-1516,"Cumberland County, NC",1516,2015,2016,74,1600000,66,1055000,8,545000,Cobb County,Cobb County-Cumberland County-NC
176,Cobb County-Glynn County-GA-1516,"Glynn County, GA",1516,2015,2016,55,1620000,61,2533000,-6,-913000,Cobb County,Cobb County-Glynn County-GA
177,Cobb County-Middlesex County-NJ-1516,"Middlesex County, NJ",1516,2015,2016,73,3947000,45,1623000,28,2324000,Cobb County,Cobb County-Middlesex County-NJ
178,Cobb County-Haralson County-GA-1516,"Haralson County, GA",1516,2015,2016,71,2103000,65,467000,6,1636000,Cobb County,Cobb County-Haralson County-GA
179,Cobb County-Brevard County-FL-1516,"Brevard County, FL",1516,2015,2016,57,1582000,78,2549000,-21,-967000,Cobb County,Cobb County-Brevard County-FL
180,Cobb County-Manatee County-FL-1516,"Manatee County, FL",1516,2015,2016,52,1987000,79,4670000,-27,-2683000,Cobb County,Cobb County-Manatee County-FL
181,Cobb County-Jefferson County-KY-1516,"Jefferson County, KY",1516,2015,2016,59,2115000,46,1483000,13,632000,Cobb County,Cobb County-Jefferson County-KY
182,Cobb County-Polk County-FL-1516,"Polk County, FL",1516,2015,2016,57,814000,57,1636000,0,-822000,Cobb County,Cobb County-Polk County-FL
183,Cobb County-El Paso County-CO-1516,"El Paso County, CO",1516,2015,2016,67,2003000,88,2011000,-21,-8000,Cobb County,Cobb County-El Paso County-CO
184,Cobb County-Denton County-TX-1516,"Denton County, TX",1516,2015,2016,75,3407000,117,6433000,-42,-3026000,Cobb County,Cobb County-Denton County-TX
185,Cobb County-Contra Costa County-CA-1516,"Contra Costa County, CA",1516,2015,2016,53,3553000,51,2505000,2,1048000,Cobb County,Cobb County-Contra Costa County-CA
186,Cobb County-Durham County-NC-1516,"Durham County, NC",1516,2015,2016,49,1840000,57,2458000,-8,-618000,Cobb County,Cobb County-Durham County-NC
187,Cobb County-Beaufort County-SC-1516,"Beaufort County, SC",1516,2015,2016,63,3029000,71,5493000,-8,-2464000,Cobb County,Cobb County-Beaufort County-SC
188,Cobb County-Henrico County-VA-1516,"Henrico County, VA",1516,2015,2016,55,3315000,35,1378000,20,1937000,Cobb County,Cobb County-Henrico County-VA
189,Cobb County-Bay County-FL-1516,"Bay County, FL",1516,2015,2016,45,863000,79,3972000,-34,-3109000,Cobb County,Cobb County-Bay County-FL
190,Cobb County-Escambia County-FL-1516,"Escambia County, FL",1516,2015,2016,50,1054000,59,1623000,-9,-569000,Cobb County,Cobb County-Escambia County-FL
191,Cobb County-Fort Bend County-TX-1516,"Fort Bend County, TX",1516,2015,2016,72,3475000,62,1738000,10,1737000,Cobb County,Cobb County-Fort Bend County-TX
192,Cobb County-Rutherford County-TN-1516,"Rutherford County, TN",1516,2015,2016,45,1396000,45,1754000,0,-358000,Cobb County,Cobb County-Rutherford County-TN
193,Cobb County-Riverside County-CA-1516,"Riverside County, CA",1516,2015,2016,58,1340000,52,1577000,6,-237000,Cobb County,Cobb County-Riverside County-CA
194,Cobb County-San Bernardino County-CA-1516,"San Bernardino County, CA",1516,2015,2016,67,1942000,55,1305000,12,637000,Cobb County,Cobb County-San Bernardino County-CA
195,Cobb County-Alachua County-FL-1516,"Alachua County, FL",1516,2015,2016,43,1736000,39,627000,4,1109000,Cobb County,Cobb County-Alachua County-FL
196,Cobb County-St. Lucie County-FL-1516,"St. Lucie County, FL",1516,2015,2016,42,903000,51,1061000,-9,-158000,Cobb County,Cobb County-St. Lucie County-FL
197,Cobb County-Gilmer County-GA-1516,"Gilmer County, GA",1516,2015,2016,35,1489000,60,3344000,-25,-1855000,Cobb County,Cobb County-Gilmer County-GA
198,Cobb County-Sacramento County-CA-1516,"Sacramento County, CA",1516,2015,2016,37,1279000,51,852000,-14,427000,Cobb County,Cobb County-Sacramento County-CA
199,Cobb County-Osceola County-FL-1516,"Osceola County, FL",1516,2015,2016,44,1010000,42,964000,2,46000,Cobb County,Cobb County-Osceola County-FL
200,Cobb County-Liberty County-GA-1516,"Liberty County, GA",1516,2015,2016,30,565000,32,616000,-2,-51000,Cobb County,Cobb County-Liberty County-GA
201,Cobb County-Hudson County-NJ-1516,"Hudson County, NJ",1516,2015,2016,49,1532000,31,1507000,18,25000,Cobb County,Cobb County-Hudson County-NJ
202,Cobb County-Okaloosa County-FL-1516,"Okaloosa County, FL",1516,2015,2016,45,828000,52,1325000,-7,-497000,Cobb County,Cobb County-Okaloosa County-FL
203,Cobb County-Spalding County-GA-1516,"Spalding County, GA",1516,2015,2016,47,771000,50,1450000,-3,-679000,Cobb County,Cobb County-Spalding County-GA
204,Cobb County-Forsyth County-NC-1516,"Forsyth County, NC",1516,2015,2016,38,635000,42,761000,-4,-126000,Cobb County,Cobb County-Forsyth County-NC
205,Cobb County-Marion County-FL-1516,"Marion County, FL",1516,2015,2016,35,593000,32,1365000,3,-772000,Cobb County,Cobb County-Marion County-FL
206,Cobb County-Williamson County-TN-1516,"Williamson County, TN",1516,2015,2016,43,2801000,90,5620000,-47,-2819000,Cobb County,Cobb County-Williamson County-TN
207,Cobb County-Anne Arundel County-MD-1516,"Anne Arundel County, MD",1516,2015,2016,32,792000,41,1167000,-9,-375000,Cobb County,Cobb County-Anne Arundel County-MD
208,Cobb County-Pierce County-WA-1516,"Pierce County, WA",1516,2015,2016,47,1108000,45,802000,2,306000,Cobb County,Cobb County-Pierce County-WA
210,DeKalb County-Fulton County-GA-1516,"Fulton County, GA",1516,2015,2016,15284,581859000,14557,709442000,727,-127583000,DeKalb County,DeKalb County-Fulton County-GA
211,DeKalb County-Gwinnett County-GA-1516,"Gwinnett County, GA",1516,2015,2016,8420,180734000,12252,235603000,-3832,-54869000,DeKalb County,DeKalb County-Gwinnett County-GA
212,DeKalb County-Cobb County-GA-1516,"Cobb County, GA",1516,2015,2016,3199,115260000,3608,123557000,-409,-8297000,DeKalb County,DeKalb County-Cobb County-GA
213,DeKalb County-Clayton County-GA-1516,"Clayton County, GA",1516,2015,2016,2484,31376000,3241,37714000,-757,-6338000,DeKalb County,DeKalb County-Clayton County-GA
214,DeKalb County-Rockdale County-GA-1516,"Rockdale County, GA",1516,2015,2016,1056,16042000,1784,28590000,-728,-12548000,DeKalb County,DeKalb County-Rockdale County-GA
215,DeKalb County-Henry County-GA-1516,"Henry County, GA",1516,2015,2016,860,19062000,1532,28161000,-672,-9099000,DeKalb County,DeKalb County-Henry County-GA
216,DeKalb County-Travis County-TX-1516,"Travis County, TX",1516,2015,2016,821,10261000,259,6535000,562,3726000,DeKalb County,DeKalb County-Travis County-TX
217,DeKalb County-Newton County-GA-1516,"Newton County, GA",1516,2015,2016,654,10258000,1012,15702000,-358,-5444000,DeKalb County,DeKalb County-Newton County-GA
218,DeKalb County-Cook County-IL-1516,"Cook County, IL",1516,2015,2016,547,17137000,307,11754000,240,5383000,DeKalb County,DeKalb County-Cook County-IL
219,DeKalb County-Los Angeles County-CA-1516,"Los Angeles County, CA",1516,2015,2016,444,17330000,392,13967000,52,3363000,DeKalb County,DeKalb County-Los Angeles County-CA
220,DeKalb County-Forsyth County-GA-1516,"Forsyth County, GA",1516,2015,2016,364,16863000,984,43093000,-620,-26230000,DeKalb County,DeKalb County-Forsyth County-GA
221,DeKalb County-Kings County-NY-1516,"Kings County, NY",1516,2015,2016,409,8697000,195,7173000,214,1524000,DeKalb County,DeKalb County-Kings County-NY
222,DeKalb County-Miami-Dade County-FL-1516,"Miami-Dade County, FL",1516,2015,2016,379,6662000,190,6485000,189,177000,DeKalb County,DeKalb County-Miami-Dade County-FL
223,DeKalb County-Clarke County-GA-1516,"Clarke County, GA",1516,2015,2016,289,8306000,168,4092000,121,4214000,DeKalb County,DeKalb County-Clarke County-GA
224,DeKalb County-Douglas County-GA-1516,"Douglas County, GA",1516,2015,2016,374,6882000,443,8158000,-69,-1276000,DeKalb County,DeKalb County-Douglas County-GA
225,DeKalb County-Broward County-FL-1516,"Broward County, FL",1516,2015,2016,358,8139000,254,10106000,104,-1967000,DeKalb County,DeKalb County-Broward County-FL
226,DeKalb County-Cherokee County-GA-1516,"Cherokee County, GA",1516,2015,2016,263,9434000,407,14257000,-144,-4823000,DeKalb County,DeKalb County-Cherokee County-GA
227,DeKalb County-Chatham County-GA-1516,"Chatham County, GA",1516,2015,2016,286,5153000,209,8527000,77,-3374000,DeKalb County,DeKalb County-Chatham County-GA
228,DeKalb County-Mecklenburg County-NC-1516,"Mecklenburg County, NC",1516,2015,2016,274,10224000,315,12804000,-41,-2580000,DeKalb County,DeKalb County-Mecklenburg County-NC
229,DeKalb County-Duval County-FL-1516,"Duval County, FL",1516,2015,2016,268,6867000,260,9101000,8,-2234000,DeKalb County,DeKalb County-Duval County-FL
230,DeKalb County-Hall County-GA-1516,"Hall County, GA",1516,2015,2016,229,7604000,284,7914000,-55,-310000,DeKalb County,DeKalb County-Hall County-GA
231,DeKalb County-Harris County-TX-1516,"Harris County, TX",1516,2015,2016,267,8598000,262,8997000,5,-399000,DeKalb County,DeKalb County-Harris County-TX
232,DeKalb County-Fayette County-GA-1516,"Fayette County, GA",1516,2015,2016,239,7902000,224,7849000,15,53000,DeKalb County,DeKalb County-Fayette County-GA
233,DeKalb County-Orange County-FL-1516,"Orange County, FL",1516,2015,2016,227,6744000,240,6472000,-13,272000,DeKalb County,DeKalb County-Orange County-FL
234,DeKalb County-Jefferson County-AL-1516,"Jefferson County, AL",1516,2015,2016,248,8898000,154,5736000,94,3162000,DeKalb County,DeKalb County-Jefferson County-AL
235,DeKalb County-Hillsborough County-FL-1516,"Hillsborough County, FL",1516,2015,2016,229,6570000,218,8716000,11,-2146000,DeKalb County,DeKalb County-Hillsborough County-FL
236,DeKalb County-Queens County-NY-1516,"Queens County, NY",1516,2015,2016,260,4791000,104,2012000,156,2779000,DeKalb County,DeKalb County-Queens County-NY
237,DeKalb County-Shelby County-TN-1516,"Shelby County, TN",1516,2015,2016,254,6743000,117,2391000,137,4352000,DeKalb County,DeKalb County-Shelby County-TN
238,DeKalb County-New York County-NY-1516,"New York County, NY",1516,2015,2016,187,11948000,171,12016000,16,-68000,DeKalb County,DeKalb County-New York County-NY
239,DeKalb County-Bibb County-GA-1516,"Bibb County, GA",1516,2015,2016,207,4691000,111,3308000,96,1383000,DeKalb County,DeKalb County-Bibb County-GA
240,DeKalb County-Muscogee County-GA-1516,"Muscogee County, GA",1516,2015,2016,212,4578000,153,2450000,59,2128000,DeKalb County,DeKalb County-Muscogee County-GA
241,DeKalb County-Davidson County-TN-1516,"Davidson County, TN",1516,2015,2016,192,6305000,187,11840000,5,-5535000,DeKalb County,DeKalb County-Davidson County-TN
242,DeKalb County-Wake County-NC-1516,"Wake County, NC",1516,2015,2016,222,6445000,157,5725000,65,720000,DeKalb County,DeKalb County-Wake County-NC
243,DeKalb County-Richmond County-GA-1516,"Richmond County, GA",1516,2015,2016,202,4187000,142,2471000,60,1716000,DeKalb County,DeKalb County-Richmond County-GA
244,DeKalb County-Dallas County-TX-1516,"Dallas County, TX",1516,2015,2016,203,6973000,275,10499000,-72,-3526000,DeKalb County,DeKalb County-Dallas County-TX
245,DeKalb County-Palm Beach County-FL-1516,"Palm Beach County, FL",1516,2015,2016,176,4228000,154,6491000,22,-2263000,DeKalb County,DeKalb County-Palm Beach County-FL
246,DeKalb County-Walton County-GA-1516,"Walton County, GA",1516,2015,2016,174,4424000,247,4883000,-73,-459000,DeKalb County,DeKalb County-Walton County-GA
247,DeKalb County-Bronx County-NY-1516,"Bronx County, NY",1516,2015,2016,199,3419000,89,1034000,110,2385000,DeKalb County,DeKalb County-Bronx County-NY
248,DeKalb County-Coweta County-GA-1516,"Coweta County, GA",1516,2015,2016,161,5043000,236,6396000,-75,-1353000,DeKalb County,DeKalb County-Coweta County-GA
249,DeKalb County-Cuyahoga County-OH-1516,"Cuyahoga County, OH",1516,2015,2016,171,4546000,87,5394000,84,-848000,DeKalb County,DeKalb County-Cuyahoga County-OH
250,DeKalb County-Richland County-SC-1516,"Richland County, SC",1516,2015,2016,164,3321000,80,2323000,84,998000,DeKalb County,DeKalb County-Richland County-SC
251,DeKalb County-Philadelphia County-PA-1516,"Philadelphia County, PA",1516,2015,2016,158,4083000,159,4220000,-1,-137000,DeKalb County,DeKalb County-Philadelphia County-PA
252,DeKalb County-Prince George's County-MD-1516,"Prince George's County, MD",1516,2015,2016,170,2757000,94,1796000,76,961000,DeKalb County,DeKalb County-Prince George's County-MD
253,DeKalb County-District of Columbia-DC-1516,"District of Columbia, DC",1516,2015,2016,136,5635000,148,6107000,-12,-472000,DeKalb County,DeKalb County-District of Columbia-DC
254,DeKalb County-Wayne County-MI-1516,"Wayne County, MI",1516,2015,2016,183,2484000,132,2332000,51,152000,DeKalb County,DeKalb County-Wayne County-MI
255,DeKalb County-San Diego County-CA-1516,"San Diego County, CA",1516,2015,2016,139,5639000,168,5913000,-29,-274000,DeKalb County,DeKalb County-San Diego County-CA
256,DeKalb County-Montgomery County-MD-1516,"Montgomery County, MD",1516,2015,2016,158,7166000,154,4690000,4,2476000,DeKalb County,DeKalb County-Montgomery County-MD
257,DeKalb County-Franklin County-OH-1516,"Franklin County, OH",1516,2015,2016,138,4938000,235,3215000,-97,1723000,DeKalb County,DeKalb County-Franklin County-OH
258,DeKalb County-Maricopa County-AZ-1516,"Maricopa County, AZ",1516,2015,2016,174,5106000,182,5575000,-8,-469000,DeKalb County,DeKalb County-Maricopa County-AZ
259,DeKalb County-Leon County-FL-1516,"Leon County, FL",1516,2015,2016,120,2410000,62,1486000,58,924000,DeKalb County,DeKalb County-Leon County-FL
260,DeKalb County-Greenville County-SC-1516,"Greenville County, SC",1516,2015,2016,125,3646000,121,4963000,4,-1317000,DeKalb County,DeKalb County-Greenville County-SC
261,DeKalb County-Paulding County-GA-1516,"Paulding County, GA",1516,2015,2016,119,3587000,153,4201000,-34,-614000,DeKalb County,DeKalb County-Paulding County-GA
262,DeKalb County-Orleans Parish-LA-1516,"Orleans Parish, LA",1516,2015,2016,130,4268000,109,1937000,21,2331000,DeKalb County,DeKalb County-Orleans Parish-LA
263,DeKalb County-Essex County-NJ-1516,"Essex County, NJ",1516,2015,2016,137,2949000,50,803000,87,2146000,DeKalb County,DeKalb County-Essex County-NJ
264,DeKalb County-Allegheny County-PA-1516,"Allegheny County, PA",1516,2015,2016,119,3468000,92,2292000,27,1176000,DeKalb County,DeKalb County-Allegheny County-PA
265,DeKalb County-Houston County-GA-1516,"Houston County, GA",1516,2015,2016,112,2277000,94,1528000,18,749000,DeKalb County,DeKalb County-Houston County-GA
266,DeKalb County-Middlesex County-MA-1516,"Middlesex County, MA",1516,2015,2016,117,6165000,92,5705000,25,460000,DeKalb County,DeKalb County-Middlesex County-MA
267,DeKalb County-King County-WA-1516,"King County, WA",1516,2015,2016,123,4540000,253,12082000,-130,-7542000,DeKalb County,DeKalb County-King County-WA
268,DeKalb County-Montgomery County-AL-1516,"Montgomery County, AL",1516,2015,2016,113,2142000,58,1297000,55,845000,DeKalb County,DeKalb County-Montgomery County-AL
269,DeKalb County-Guilford County-NC-1516,"Guilford County, NC",1516,2015,2016,102,2296000,49,1204000,53,1092000,DeKalb County,DeKalb County-Guilford County-NC
270,DeKalb County-Durham County-NC-1516,"Durham County, NC",1516,2015,2016,105,3733000,90,2178000,15,1555000,DeKalb County,DeKalb County-Durham County-NC
271,DeKalb County-Carroll County-GA-1516,"Carroll County, GA",1516,2015,2016,110,2255000,88,1649000,22,606000,DeKalb County,DeKalb County-Carroll County-GA
272,DeKalb County-Hamilton County-OH-1516,"Hamilton County, OH",1516,2015,2016,148,5154000,109,3229000,39,1925000,DeKalb County,DeKalb County-Hamilton County-OH
273,DeKalb County-Milwaukee County-WI-1516,"Milwaukee County, WI",1516,2015,2016,139,3211000,67,1612000,72,1599000,DeKalb County,DeKalb County-Milwaukee County-WI
274,DeKalb County-Charleston County-SC-1516,"Charleston County, SC",1516,2015,2016,105,3732000,134,5076000,-29,-1344000,DeKalb County,DeKalb County-Charleston County-SC
275,DeKalb County-Dougherty County-GA-1516,"Dougherty County, GA",1516,2015,2016,119,1789000,66,663000,53,1126000,DeKalb County,DeKalb County-Dougherty County-GA
276,DeKalb County-Hennepin County-MN-1516,"Hennepin County, MN",1516,2015,2016,106,4240000,81,2363000,25,1877000,DeKalb County,DeKalb County-Hennepin County-MN
277,DeKalb County-Pinellas County-FL-1516,"Pinellas County, FL",1516,2015,2016,100,2608000,125,5928000,-25,-3320000,DeKalb County,DeKalb County-Pinellas County-FL
278,DeKalb County-Baltimore city-MD-1516,"Baltimore city, MD",1516,2015,2016,124,4871000,69,2690000,55,2181000,DeKalb County,DeKalb County-Baltimore city-MD
279,DeKalb County-Fairfax County-VA-1516,"Fairfax County, VA",1516,2015,2016,103,4554000,119,5757000,-16,-1203000,DeKalb County,DeKalb County-Fairfax County-VA
280,DeKalb County-Marion County-IN-1516,"Marion County, IN",1516,2015,2016,104,1893000,95,1360000,9,533000,DeKalb County,DeKalb County-Marion County-IN
281,DeKalb County-Suffolk County-MA-1516,"Suffolk County, MA",1516,2015,2016,94,3099000,67,2597000,27,502000,DeKalb County,DeKalb County-Suffolk County-MA
282,DeKalb County-Knox County-TN-1516,"Knox County, TN",1516,2015,2016,87,2084000,63,2347000,24,-263000,DeKalb County,DeKalb County-Knox County-TN
283,DeKalb County-San Francisco County-CA-1516,"San Francisco County, CA",1516,2015,2016,79,6201000,78,4832000,1,1369000,DeKalb County,DeKalb County-San Francisco County-CA
284,DeKalb County-Fairfield County-CT-1516,"Fairfield County, CT",1516,2015,2016,84,5037000,46,1403000,38,3634000,DeKalb County,DeKalb County-Fairfield County-CT
285,DeKalb County-Clark County-NV-1516,"Clark County, NV",1516,2015,2016,96,2133000,103,2698000,-7,-565000,DeKalb County,DeKalb County-Clark County-NV
286,DeKalb County-Alachua County-FL-1516,"Alachua County, FL",1516,2015,2016,85,2217000,44,1733000,41,484000,DeKalb County,DeKalb County-Alachua County-FL
287,DeKalb County-East Baton Rouge Parish-LA-1516,"East Baton Rouge Parish, LA",1516,2015,2016,100,1221000,114,2418000,-14,-1197000,DeKalb County,DeKalb County-East Baton Rouge Parish-LA
288,DeKalb County-Mobile County-AL-1516,"Mobile County, AL",1516,2015,2016,87,1592000,67,1089000,20,503000,DeKalb County,DeKalb County-Mobile County-AL
289,DeKalb County-Lowndes County-GA-1516,"Lowndes County, GA",1516,2015,2016,77,1076000,42,716000,35,360000,DeKalb County,DeKalb County-Lowndes County-GA
290,DeKalb County-Jefferson County-KY-1516,"Jefferson County, KY",1516,2015,2016,107,2586000,81,2252000,26,334000,DeKalb County,DeKalb County-Jefferson County-KY
291,DeKalb County-St. Louis County-MO-1516,"St. Louis County, MO",1516,2015,2016,99,3182000,69,1571000,30,1611000,DeKalb County,DeKalb County-St. Louis County-MO
292,DeKalb County-Barrow County-GA-1516,"Barrow County, GA",1516,2015,2016,92,2325000,112,2810000,-20,-485000,DeKalb County,DeKalb County-Barrow County-GA
293,DeKalb County-Bexar County-TX-1516,"Bexar County, TX",1516,2015,2016,95,2898000,97,2451000,-2,447000,DeKalb County,DeKalb County-Bexar County-TX
294,DeKalb County-Santa Clara County-CA-1516,"Santa Clara County, CA",1516,2015,2016,86,5342000,127,17893000,-41,-12551000,DeKalb County,DeKalb County-Santa Clara County-CA
295,DeKalb County-Tarrant County-TX-1516,"Tarrant County, TX",1516,2015,2016,81,2781000,130,4323000,-49,-1542000,DeKalb County,DeKalb County-Tarrant County-TX
296,DeKalb County-Seminole County-FL-1516,"Seminole County, FL",1516,2015,2016,72,2196000,79,3602000,-7,-1406000,DeKalb County,DeKalb County-Seminole County-FL
297,DeKalb County-Alameda County-CA-1516,"Alameda County, CA",1516,2015,2016,72,3882000,117,3963000,-45,-81000,DeKalb County,DeKalb County-Alameda County-CA
298,DeKalb County-Columbia County-GA-1516,"Columbia County, GA",1516,2015,2016,76,2402000,64,1684000,12,718000,DeKalb County,DeKalb County-Columbia County-GA
299,DeKalb County-Bergen County-NJ-1516,"Bergen County, NJ",1516,2015,2016,82,4931000,46,2022000,36,2909000,DeKalb County,DeKalb County-Bergen County-NJ
300,DeKalb County-Hamilton County-TN-1516,"Hamilton County, TN",1516,2015,2016,69,2144000,109,3220000,-40,-1076000,DeKalb County,DeKalb County-Hamilton County-TN
301,DeKalb County-Madison County-AL-1516,"Madison County, AL",1516,2015,2016,68,1337000,61,2630000,7,-1293000,DeKalb County,DeKalb County-Madison County-AL
302,DeKalb County-Denver County-CO-1516,"Denver County, CO",1516,2015,2016,65,2858000,114,5780000,-49,-2922000,DeKalb County,DeKalb County-Denver County-CO
303,DeKalb County-Lee County-AL-1516,"Lee County, AL",1516,2015,2016,58,1395000,61,896000,-3,499000,DeKalb County,DeKalb County-Lee County-AL
304,DeKalb County-Bulloch County-GA-1516,"Bulloch County, GA",1516,2015,2016,51,1113000,37,610000,14,503000,DeKalb County,DeKalb County-Bulloch County-GA
305,DeKalb County-Jefferson Parish-LA-1516,"Jefferson Parish, LA",1516,2015,2016,71,2020000,40,798000,31,1222000,DeKalb County,DeKalb County-Jefferson Parish-LA
306,DeKalb County-Suffolk County-NY-1516,"Suffolk County, NY",1516,2015,2016,80,1877000,46,639000,34,1238000,DeKalb County,DeKalb County-Suffolk County-NY
307,DeKalb County-Westchester County-NY-1516,"Westchester County, NY",1516,2015,2016,89,2154000,52,6078000,37,-3924000,DeKalb County,DeKalb County-Westchester County-NY
308,DeKalb County-Volusia County-FL-1516,"Volusia County, FL",1516,2015,2016,64,1064000,46,1756000,18,-692000,DeKalb County,DeKalb County-Volusia County-FL
309,DeKalb County-Arlington County-VA-1516,"Arlington County, VA",1516,2015,2016,47,3261000,44,2047000,3,1214000,DeKalb County,DeKalb County-Arlington County-VA
310,DeKalb County-Orange County-CA-1516,"Orange County, CA",1516,2015,2016,66,2794000,76,3999000,-10,-1205000,DeKalb County,DeKalb County-Orange County-CA
311,DeKalb County-Baltimore County-MD-1516,"Baltimore County, MD",1516,2015,2016,66,1958000,84,2313000,-18,-355000,DeKalb County,DeKalb County-Baltimore County-MD
312,DeKalb County-Oakland County-MI-1516,"Oakland County, MI",1516,2015,2016,67,2283000,59,1634000,8,649000,DeKalb County,DeKalb County-Oakland County-MI
313,DeKalb County-Glynn County-GA-1516,"Glynn County, GA",1516,2015,2016,63,1595000,67,3786000,-4,-2191000,DeKalb County,DeKalb County-Glynn County-GA
314,DeKalb County-Spalding County-GA-1516,"Spalding County, GA",1516,2015,2016,63,979000,64,782000,-1,197000,DeKalb County,DeKalb County-Spalding County-GA
315,DeKalb County-Bartow County-GA-1516,"Bartow County, GA",1516,2015,2016,61,1427000,80,1709000,-19,-282000,DeKalb County,DeKalb County-Bartow County-GA
316,DeKalb County-Ramsey County-MN-1516,"Ramsey County, MN",1516,2015,2016,51,1475000,72,1500000,-21,-25000,DeKalb County,DeKalb County-Ramsey County-MN
317,DeKalb County-Floyd County-GA-1516,"Floyd County, GA",1516,2015,2016,54,1854000,46,1021000,8,833000,DeKalb County,DeKalb County-Floyd County-GA
318,DeKalb County-Norfolk County-MA-1516,"Norfolk County, MA",1516,2015,2016,52,3274000,34,1810000,18,1464000,DeKalb County,DeKalb County-Norfolk County-MA
319,DeKalb County-Arapahoe County-CO-1516,"Arapahoe County, CO",1516,2015,2016,59,1994000,56,1846000,3,148000,DeKalb County,DeKalb County-Arapahoe County-CO
320,DeKalb County-Lee County-FL-1516,"Lee County, FL",1516,2015,2016,52,1937000,47,2032000,5,-95000,DeKalb County,DeKalb County-Lee County-FL
321,DeKalb County-Hudson County-NJ-1516,"Hudson County, NJ",1516,2015,2016,66,3051000,40,2191000,26,860000,DeKalb County,DeKalb County-Hudson County-NJ
322,DeKalb County-Cumberland County-NC-1516,"Cumberland County, NC",1516,2015,2016,50,1329000,47,888000,3,441000,DeKalb County,DeKalb County-Cumberland County-NC
323,DeKalb County-Collin County-TX-1516,"Collin County, TX",1516,2015,2016,61,3343000,94,4315000,-33,-972000,DeKalb County,DeKalb County-Collin County-TX
324,DeKalb County-Buncombe County-NC-1516,"Buncombe County, NC",1516,2015,2016,46,1232000,77,4715000,-31,-3483000,DeKalb County,DeKalb County-Buncombe County-NC
325,DeKalb County-Richmond city-VA-1516,"Richmond city, VA",1516,2015,2016,58,1699000,42,1363000,16,336000,DeKalb County,DeKalb County-Richmond city-VA
326,DeKalb County-Escambia County-FL-1516,"Escambia County, FL",1516,2015,2016,51,1113000,51,1111000,0,2000,DeKalb County,DeKalb County-Escambia County-FL
327,DeKalb County-New Castle County-DE-1516,"New Castle County, DE",1516,2015,2016,49,1899000,28,753000,21,1146000,DeKalb County,DeKalb County-New Castle County-DE
328,DeKalb County-Troup County-GA-1516,"Troup County, GA",1516,2015,2016,39,893000,33,535000,6,358000,DeKalb County,DeKalb County-Troup County-GA
329,DeKalb County-Jackson County-MO-1516,"Jackson County, MO",1516,2015,2016,63,1229000,45,1067000,18,162000,DeKalb County,DeKalb County-Jackson County-MO
330,DeKalb County-Middlesex County-NJ-1516,"Middlesex County, NJ",1516,2015,2016,65,2263000,72,2454000,-7,-191000,DeKalb County,DeKalb County-Middlesex County-NJ
331,DeKalb County-Brevard County-FL-1516,"Brevard County, FL",1516,2015,2016,47,1577000,49,1897000,-2,-320000,DeKalb County,DeKalb County-Brevard County-FL
332,DeKalb County-Sacramento County-CA-1516,"Sacramento County, CA",1516,2015,2016,48,1225000,37,891000,11,334000,DeKalb County,DeKalb County-Sacramento County-CA
333,DeKalb County-San Mateo County-CA-1516,"San Mateo County, CA",1516,2015,2016,48,3032000,36,2258000,12,774000,DeKalb County,DeKalb County-San Mateo County-CA
334,DeKalb County-Loudoun County-VA-1516,"Loudoun County, VA",1516,2015,2016,51,2988000,55,2260000,-4,728000,DeKalb County,DeKalb County-Loudoun County-VA
335,DeKalb County-Virginia Beach city-VA-1516,"Virginia Beach city, VA",1516,2015,2016,48,1195000,36,474000,12,721000,DeKalb County,DeKalb County-Virginia Beach city-VA
336,DeKalb County-San Bernardino County-CA-1516,"San Bernardino County, CA",1516,2015,2016,46,1056000,30,748000,16,308000,DeKalb County,DeKalb County-San Bernardino County-CA
337,DeKalb County-Liberty County-GA-1516,"Liberty County, GA",1516,2015,2016,45,917000,48,765000,-3,152000,DeKalb County,DeKalb County-Liberty County-GA
338,DeKalb County-Washtenaw County-MI-1516,"Washtenaw County, MI",1516,2015,2016,48,1320000,45,2103000,3,-783000,DeKalb County,DeKalb County-Washtenaw County-MI
339,DeKalb County-Jackson County-GA-1516,"Jackson County, GA",1516,2015,2016,36,888000,57,1473000,-21,-585000,DeKalb County,DeKalb County-Jackson County-GA
340,DeKalb County-Multnomah County-OR-1516,"Multnomah County, OR",1516,2015,2016,29,795000,60,2503000,-31,-1708000,DeKalb County,DeKalb County-Multnomah County-OR
341,DeKalb County-Baldwin County-GA-1516,"Baldwin County, GA",1516,2015,2016,34,493000,52,453000,-18,40000,DeKalb County,DeKalb County-Baldwin County-GA
342,DeKalb County-Honolulu County-HI-1516,"Honolulu County, HI",1516,2015,2016,41,1385000,50,1362000,-9,23000,DeKalb County,DeKalb County-Honolulu County-HI
343,DeKalb County-Norfolk city-VA-1516,"Norfolk city, VA",1516,2015,2016,43,890000,28,1235000,15,-345000,DeKalb County,DeKalb County-Norfolk city-VA
344,DeKalb County-Polk County-FL-1516,"Polk County, FL",1516,2015,2016,36,949000,46,1204000,-10,-255000,DeKalb County,DeKalb County-Polk County-FL
345,DeKalb County-Howard County-MD-1516,"Howard County, MD",1516,2015,2016,35,1383000,38,1443000,-3,-60000,DeKalb County,DeKalb County-Howard County-MD
346,DeKalb County-Summit County-OH-1516,"Summit County, OH",1516,2015,2016,45,1063000,44,683000,1,380000,DeKalb County,DeKalb County-Summit County-OH
347,DeKalb County-Alexandria city-VA-1516,"Alexandria city, VA",1516,2015,2016,34,2428000,35,1485000,-1,943000,DeKalb County,DeKalb County-Alexandria city-VA
348,DeKalb County-Osceola County-FL-1516,"Osceola County, FL",1516,2015,2016,43,441000,45,983000,-2,-542000,DeKalb County,DeKalb County-Osceola County-FL
349,DeKalb County-Fayette County-KY-1516,"Fayette County, KY",1516,2015,2016,32,1115000,64,1864000,-32,-749000,DeKalb County,DeKalb County-Fayette County-KY
350,DeKalb County-Pulaski County-AR-1516,"Pulaski County, AR",1516,2015,2016,41,845000,50,1910000,-9,-1065000,DeKalb County,DeKalb County-Pulaski County-AR
351,DeKalb County-Contra Costa County-CA-1516,"Contra Costa County, CA",1516,2015,2016,42,1956000,81,2808000,-39,-852000,DeKalb County,DeKalb County-Contra Costa County-CA
352,DeKalb County-Riverside County-CA-1516,"Riverside County, CA",1516,2015,2016,35,698000,44,1051000,-9,-353000,DeKalb County,DeKalb County-Riverside County-CA
353,DeKalb County-El Paso County-CO-1516,"El Paso County, CO",1516,2015,2016,47,1058000,41,983000,6,75000,DeKalb County,DeKalb County-El Paso County-CO
354,DeKalb County-Beaufort County-SC-1516,"Beaufort County, SC",1516,2015,2016,34,1342000,54,4095000,-20,-2753000,DeKalb County,DeKalb County-Beaufort County-SC
356,Douglas County-Cobb County-GA-1516,"Cobb County, GA",1516,2015,2016,2820,42738000,2071,41114000,749,1624000,Douglas County,Douglas County-Cobb County-GA
357,Douglas County-Fulton County-GA-1516,"Fulton County, GA",1516,2015,2016,1442,26579000,1305,25847000,137,732000,Douglas County,Douglas County-Fulton County-GA
358,Douglas County-Carroll County-GA-1516,"Carroll County, GA",1516,2015,2016,863,16564000,1195,25789000,-332,-9225000,Douglas County,Douglas County-Carroll County-GA
359,Douglas County-Paulding County-GA-1516,"Paulding County, GA",1516,2015,2016,880,15540000,1176,20533000,-296,-4993000,Douglas County,Douglas County-Paulding County-GA
360,Douglas County-DeKalb County-GA-1516,"DeKalb County, GA",1516,2015,2016,443,8158000,374,6882000,69,1276000,Douglas County,Douglas County-DeKalb County-GA
361,Douglas County-Gwinnett County-GA-1516,"Gwinnett County, GA",1516,2015,2016,315,5169000,354,6366000,-39,-1197000,Douglas County,Douglas County-Gwinnett County-GA
362,Douglas County-Clayton County-GA-1516,"Clayton County, GA",1516,2015,2016,280,4058000,259,3897000,21,161000,Douglas County,Douglas County-Clayton County-GA
363,Douglas County-Henry County-GA-1516,"Henry County, GA",1516,2015,2016,124,2011000,160,2794000,-36,-783000,Douglas County,Douglas County-Henry County-GA
364,Douglas County-Coweta County-GA-1516,"Coweta County, GA",1516,2015,2016,92,3000000,128,3502000,-36,-502000,Douglas County,Douglas County-Coweta County-GA
365,Douglas County-Cherokee County-GA-1516,"Cherokee County, GA",1516,2015,2016,76,1529000,143,3702000,-67,-2173000,Douglas County,Douglas County-Cherokee County-GA
366,Douglas County-Broward County-FL-1516,"Broward County, FL",1516,2015,2016,85,1189000,45,1111000,40,78000,Douglas County,Douglas County-Broward County-FL
367,Douglas County-Haralson County-GA-1516,"Haralson County, GA",1516,2015,2016,79,1136000,153,2648000,-74,-1512000,Douglas County,Douglas County-Haralson County-GA
368,Douglas County-Los Angeles County-CA-1516,"Los Angeles County, CA",1516,2015,2016,62,1025000,55,1210000,7,-185000,Douglas County,Douglas County-Los Angeles County-CA
370,Fayette County-Fulton County-GA-1516,"Fulton County, GA",1516,2015,2016,1213,33613000,874,34802000,339,-1189000,Fayette County,Fayette County-Fulton County-GA
371,Fayette County-Clayton County-GA-1516,"Clayton County, GA",1516,2015,2016,951,21455000,510,7866000,441,13589000,Fayette County,Fayette County-Clayton County-GA
372,Fayette County-Coweta County-GA-1516,"Coweta County, GA",1516,2015,2016,811,31614000,1203,41796000,-392,-10182000,Fayette County,Fayette County-Coweta County-GA
373,Fayette County-Henry County-GA-1516,"Henry County, GA",1516,2015,2016,374,10711000,250,5327000,124,5384000,Fayette County,Fayette County-Henry County-GA
374,Fayette County-Cobb County-GA-1516,"Cobb County, GA",1516,2015,2016,280,9904000,259,10559000,21,-655000,Fayette County,Fayette County-Cobb County-GA
375,Fayette County-DeKalb County-GA-1516,"DeKalb County, GA",1516,2015,2016,224,7849000,239,7902000,-15,-53000,Fayette County,Fayette County-DeKalb County-GA
376,Fayette County-Gwinnett County-GA-1516,"Gwinnett County, GA",1516,2015,2016,117,3515000,137,4163000,-20,-648000,Fayette County,Fayette County-Gwinnett County-GA
377,Fayette County-Spalding County-GA-1516,"Spalding County, GA",1516,2015,2016,114,2625000,163,3965000,-49,-1340000,Fayette County,Fayette County-Spalding County-GA
378,Fayette County-Los Angeles County-CA-1516,"Los Angeles County, CA",1516,2015,2016,81,4623000,46,1747000,35,2876000,Fayette County,Fayette County-Los Angeles County-CA
380,Forsyth County-Fulton County-GA-1516,"Fulton County, GA",1516,2015,2016,5731,238438000,1992,118731000,3739,119707000,Forsyth County,Forsyth County-Fulton County-GA
381,Forsyth County-Gwinnett County-GA-1516,"Gwinnett County, GA",1516,2015,2016,2307,91533000,1358,47312000,949,44221000,Forsyth County,Forsyth County-Gwinnett County-GA
382,Forsyth County-DeKalb County-GA-1516,"DeKalb County, GA",1516,2015,2016,984,43093000,364,16863000,620,26230000,Forsyth County,Forsyth County-DeKalb County-GA
383,Forsyth County-Cobb County-GA-1516,"Cobb County, GA",1516,2015,2016,936,41457000,355,13789000,581,27668000,Forsyth County,Forsyth County-Cobb County-GA
384,Forsyth County-Hall County-GA-1516,"Hall County, GA",1516,2015,2016,489,13728000,661,20377000,-172,-6649000,Forsyth County,Forsyth County-Hall County-GA
385,Forsyth County-Cherokee County-GA-1516,"Cherokee County, GA",1516,2015,2016,462,25906000,643,30139000,-181,-4233000,Forsyth County,Forsyth County-Cherokee County-GA
386,Forsyth County-Dawson County-GA-1516,"Dawson County, GA",1516,2015,2016,449,11276000,734,31665000,-285,-20389000,Forsyth County,Forsyth County-Dawson County-GA
387,Forsyth County-Lumpkin County-GA-1516,"Lumpkin County, GA",1516,2015,2016,162,3862000,284,6613000,-122,-2751000,Forsyth County,Forsyth County-Lumpkin County-GA
388,Forsyth County-Henry County-GA-1516,"Henry County, GA",1516,2015,2016,109,3152000,44,1373000,65,1779000,Forsyth County,Forsyth County-Henry County-GA
389,Forsyth County-Broward County-FL-1516,"Broward County, FL",1516,2015,2016,110,3870000,55,2760000,55,1110000,Forsyth County,Forsyth County-Broward County-FL
390,Forsyth County-Hillsborough County-FL-1516,"Hillsborough County, FL",1516,2015,2016,89,3306000,46,1764000,43,1542000,Forsyth County,Forsyth County-Hillsborough County-FL
391,Forsyth County-Palm Beach County-FL-1516,"Palm Beach County, FL",1516,2015,2016,76,1818000,41,1580000,35,238000,Forsyth County,Forsyth County-Palm Beach County-FL
392,Forsyth County-Pickens County-GA-1516,"Pickens County, GA",1516,2015,2016,72,2856000,90,4793000,-18,-1937000,Forsyth County,Forsyth County-Pickens County-GA
393,Forsyth County-Maricopa County-AZ-1516,"Maricopa County, AZ",1516,2015,2016,90,3195000,62,2570000,28,625000,Forsyth County,Forsyth County-Maricopa County-AZ
394,Forsyth County-Clarke County-GA-1516,"Clarke County, GA",1516,2015,2016,40,1915000,49,1184000,-9,731000,Forsyth County,Forsyth County-Clarke County-GA
395,Forsyth County-Los Angeles County-CA-1516,"Los Angeles County, CA",1516,2015,2016,71,3033000,52,1376000,19,1657000,Forsyth County,Forsyth County-Los Angeles County-CA
396,Forsyth County-Pinellas County-FL-1516,"Pinellas County, FL",1516,2015,2016,68,4830000,55,2418000,13,2412000,Forsyth County,Forsyth County-Pinellas County-FL
397,Forsyth County-Barrow County-GA-1516,"Barrow County, GA",1516,2015,2016,73,1438000,65,2194000,8,-756000,Forsyth County,Forsyth County-Barrow County-GA
398,Forsyth County-Harris County-TX-1516,"Harris County, TX",1516,2015,2016,60,3027000,61,4833000,-1,-1806000,Forsyth County,Forsyth County-Harris County-TX
399,Forsyth County-Duval County-FL-1516,"Duval County, FL",1516,2015,2016,47,1641000,44,2669000,3,-1028000,Forsyth County,Forsyth County-Duval County-FL
400,Forsyth County-Jackson County-GA-1516,"Jackson County, GA",1516,2015,2016,37,1098000,71,2129000,-34,-1031000,Forsyth County,Forsyth County-Jackson County-GA
401,Forsyth County-Wake County-NC-1516,"Wake County, NC",1516,2015,2016,55,2411000,65,2222000,-10,189000,Forsyth County,Forsyth County-Wake County-NC
402,Forsyth County-Chatham County-GA-1516,"Chatham County, GA",1516,2015,2016,38,1447000,39,1706000,-1,-259000,Forsyth County,Forsyth County-Chatham County-GA
404,Fulton County-DeKalb County-GA-1516,"DeKalb County, GA",1516,2015,2016,14557,709442000,15284,581859000,-727,127583000,Fulton County,Fulton County-DeKalb County-GA
405,Fulton County-Cobb County-GA-1516,"Cobb County, GA",1516,2015,2016,8487,394280000,8892,349591000,-405,44689000,Fulton County,Fulton County-Cobb County-GA
406,Fulton County-Gwinnett County-GA-1516,"Gwinnett County, GA",1516,2015,2016,5706,224199000,6623,181298000,-917,42901000,Fulton County,Fulton County-Gwinnett County-GA
407,Fulton County-Clayton County-GA-1516,"Clayton County, GA",1516,2015,2016,5871,75446000,7117,76405000,-1246,-959000,Fulton County,Fulton County-Clayton County-GA
408,Fulton County-Forsyth County-GA-1516,"Forsyth County, GA",1516,2015,2016,1992,118731000,5731,238438000,-3739,-119707000,Fulton County,Fulton County-Forsyth County-GA
409,Fulton County-Douglas County-GA-1516,"Douglas County, GA",1516,2015,2016,1305,25847000,1442,26579000,-137,-732000,Fulton County,Fulton County-Douglas County-GA
410,Fulton County-Cherokee County-GA-1516,"Cherokee County, GA",1516,2015,2016,1216,57169000,2265,97119000,-1049,-39950000,Fulton County,Fulton County-Cherokee County-GA
411,Fulton County-Travis County-TX-1516,"Travis County, TX",1516,2015,2016,1121,27131000,380,11572000,741,15559000,Fulton County,Fulton County-Travis County-TX
412,Fulton County-Henry County-GA-1516,"Henry County, GA",1516,2015,2016,1064,35711000,1255,25608000,-191,10103000,Fulton County,Fulton County-Henry County-GA
413,Fulton County-Cook County-IL-1516,"Cook County, IL",1516,2015,2016,989,57979000,591,31393000,398,26586000,Fulton County,Fulton County-Cook County-IL
414,Fulton County-Fayette County-GA-1516,"Fayette County, GA",1516,2015,2016,874,34802000,1213,33613000,-339,1189000,Fulton County,Fulton County-Fayette County-GA
415,Fulton County-Los Angeles County-CA-1516,"Los Angeles County, CA",1516,2015,2016,724,66056000,681,29398000,43,36658000,Fulton County,Fulton County-Los Angeles County-CA
416,Fulton County-Coweta County-GA-1516,"Coweta County, GA",1516,2015,2016,739,19069000,919,24224000,-180,-5155000,Fulton County,Fulton County-Coweta County-GA
417,Fulton County-Mecklenburg County-NC-1516,"Mecklenburg County, NC",1516,2015,2016,524,27042000,446,21005000,78,6037000,Fulton County,Fulton County-Mecklenburg County-NC
418,Fulton County-New York County-NY-1516,"New York County, NY",1516,2015,2016,478,54776000,434,42952000,44,11824000,Fulton County,Fulton County-New York County-NY
419,Fulton County-Miami-Dade County-FL-1516,"Miami-Dade County, FL",1516,2015,2016,555,19421000,385,29702000,170,-10281000,Fulton County,Fulton County-Miami-Dade County-FL
420,Fulton County-Broward County-FL-1516,"Broward County, FL",1516,2015,2016,576,19826000,383,39879000,193,-20053000,Fulton County,Fulton County-Broward County-FL
421,Fulton County-Orange County-FL-1516,"Orange County, FL",1516,2015,2016,443,15560000,320,13582000,123,1978000,Fulton County,Fulton County-Orange County-FL
422,Fulton County-Kings County-NY-1516,"Kings County, NY",1516,2015,2016,474,21278000,246,8693000,228,12585000,Fulton County,Fulton County-Kings County-NY
423,Fulton County-Clarke County-GA-1516,"Clarke County, GA",1516,2015,2016,343,12430000,237,7170000,106,5260000,Fulton County,Fulton County-Clarke County-GA
424,Fulton County-Chatham County-GA-1516,"Chatham County, GA",1516,2015,2016,406,12440000,281,10887000,125,1553000,Fulton County,Fulton County-Chatham County-GA
425,Fulton County-Harris County-TX-1516,"Harris County, TX",1516,2015,2016,416,20672000,379,46500000,37,-25828000,Fulton County,Fulton County-Harris County-TX
426,Fulton County-Duval County-FL-1516,"Duval County, FL",1516,2015,2016,374,14133000,305,14409000,69,-276000,Fulton County,Fulton County-Duval County-FL
427,Fulton County-Rockdale County-GA-1516,"Rockdale County, GA",1516,2015,2016,414,10213000,300,6804000,114,3409000,Fulton County,Fulton County-Rockdale County-GA
428,Fulton County-Jefferson County-AL-1516,"Jefferson County, AL",1516,2015,2016,370,17193000,214,8670000,156,8523000,Fulton County,Fulton County-Jefferson County-AL
429,Fulton County-Davidson County-TN-1516,"Davidson County, TN",1516,2015,2016,315,16195000,275,19439000,40,-3244000,Fulton County,Fulton County-Davidson County-TN
430,Fulton County-Hillsborough County-FL-1516,"Hillsborough County, FL",1516,2015,2016,350,17779000,367,21971000,-17,-4192000,Fulton County,Fulton County-Hillsborough County-FL
431,Fulton County-Muscogee County-GA-1516,"Muscogee County, GA",1516,2015,2016,343,9775000,189,4358000,154,5417000,Fulton County,Fulton County-Muscogee County-GA
432,Fulton County-Dallas County-TX-1516,"Dallas County, TX",1516,2015,2016,344,20301000,380,30023000,-36,-9722000,Fulton County,Fulton County-Dallas County-TX
433,Fulton County-District of Columbia-DC-1516,"District of Columbia, DC",1516,2015,2016,258,15969000,214,16077000,44,-108000,Fulton County,Fulton County-District of Columbia-DC
434,Fulton County-Palm Beach County-FL-1516,"Palm Beach County, FL",1516,2015,2016,326,16131000,292,25288000,34,-9157000,Fulton County,Fulton County-Palm Beach County-FL
435,Fulton County-Queens County-NY-1516,"Queens County, NY",1516,2015,2016,321,10752000,126,3609000,195,7143000,Fulton County,Fulton County-Queens County-NY
436,Fulton County-Paulding County-GA-1516,"Paulding County, GA",1516,2015,2016,319,8256000,422,10214000,-103,-1958000,Fulton County,Fulton County-Paulding County-GA
437,Fulton County-Bibb County-GA-1516,"Bibb County, GA",1516,2015,2016,302,8327000,116,3443000,186,4884000,Fulton County,Fulton County-Bibb County-GA
438,Fulton County-Hall County-GA-1516,"Hall County, GA",1516,2015,2016,249,9153000,330,15708000,-81,-6555000,Fulton County,Fulton County-Hall County-GA
439,Fulton County-Maricopa County-AZ-1516,"Maricopa County, AZ",1516,2015,2016,313,13577000,268,16251000,45,-2674000,Fulton County,Fulton County-Maricopa County-AZ
440,Fulton County-Newton County-GA-1516,"Newton County, GA",1516,2015,2016,286,6055000,243,4901000,43,1154000,Fulton County,Fulton County-Newton County-GA
441,Fulton County-Wake County-NC-1516,"Wake County, NC",1516,2015,2016,273,16193000,232,11438000,41,4755000,Fulton County,Fulton County-Wake County-NC
442,Fulton County-Shelby County-TN-1516,"Shelby County, TN",1516,2015,2016,273,9940000,176,7797000,97,2143000,Fulton County,Fulton County-Shelby County-TN
443,Fulton County-Richmond County-GA-1516,"Richmond County, GA",1516,2015,2016,231,7301000,180,3696000,51,3605000,Fulton County,Fulton County-Richmond County-GA
444,Fulton County-Fairfax County-VA-1516,"Fairfax County, VA",1516,2015,2016,238,11739000,186,8867000,52,2872000,Fulton County,Fulton County-Fairfax County-VA
445,Fulton County-Philadelphia County-PA-1516,"Philadelphia County, PA",1516,2015,2016,215,8631000,158,6858000,57,1773000,Fulton County,Fulton County-Philadelphia County-PA
446,Fulton County-Leon County-FL-1516,"Leon County, FL",1516,2015,2016,204,7476000,66,2304000,138,5172000,Fulton County,Fulton County-Leon County-FL
447,Fulton County-Carroll County-GA-1516,"Carroll County, GA",1516,2015,2016,206,5610000,155,3130000,51,2480000,Fulton County,Fulton County-Carroll County-GA
448,Fulton County-Hennepin County-MN-1516,"Hennepin County, MN",1516,2015,2016,220,15919000,124,5382000,96,10537000,Fulton County,Fulton County-Hennepin County-MN
449,Fulton County-King County-WA-1516,"King County, WA",1516,2015,2016,215,11028000,367,26342000,-152,-15314000,Fulton County,Fulton County-King County-WA
450,Fulton County-Allegheny County-PA-1516,"Allegheny County, PA",1516,2015,2016,208,8890000,121,5293000,87,3597000,Fulton County,Fulton County-Allegheny County-PA
451,Fulton County-Richland County-SC-1516,"Richland County, SC",1516,2015,2016,205,6754000,82,2205000,123,4549000,Fulton County,Fulton County-Richland County-SC
452,Fulton County-Pinellas County-FL-1516,"Pinellas County, FL",1516,2015,2016,185,9712000,246,19016000,-61,-9304000,Fulton County,Fulton County-Pinellas County-FL
453,Fulton County-Alameda County-CA-1516,"Alameda County, CA",1516,2015,2016,191,9675000,192,9828000,-1,-153000,Fulton County,Fulton County-Alameda County-CA
454,Fulton County-Greenville County-SC-1516,"Greenville County, SC",1516,2015,2016,173,8838000,156,7979000,17,859000,Fulton County,Fulton County-Greenville County-SC
455,Fulton County-Cuyahoga County-OH-1516,"Cuyahoga County, OH",1516,2015,2016,191,6986000,106,3809000,85,3177000,Fulton County,Fulton County-Cuyahoga County-OH
456,Fulton County-Hamilton County-TN-1516,"Hamilton County, TN",1516,2015,2016,171,8582000,159,5684000,12,2898000,Fulton County,Fulton County-Hamilton County-TN
457,Fulton County-San Diego County-CA-1516,"San Diego County, CA",1516,2015,2016,193,7892000,239,15610000,-46,-7718000,Fulton County,Fulton County-San Diego County-CA
458,Fulton County-Franklin County-OH-1516,"Franklin County, OH",1516,2015,2016,203,9961000,140,4616000,63,5345000,Fulton County,Fulton County-Franklin County-OH
459,Fulton County-Middlesex County-MA-1516,"Middlesex County, MA",1516,2015,2016,178,12956000,158,9875000,20,3081000,Fulton County,Fulton County-Middlesex County-MA
460,Fulton County-Bergen County-NJ-1516,"Bergen County, NJ",1516,2015,2016,290,19575000,62,3243000,228,16332000,Fulton County,Fulton County-Bergen County-NJ
461,Fulton County-Charleston County-SC-1516,"Charleston County, SC",1516,2015,2016,164,7030000,232,16483000,-68,-9453000,Fulton County,Fulton County-Charleston County-SC
462,Fulton County-Suffolk County-MA-1516,"Suffolk County, MA",1516,2015,2016,140,8875000,126,9036000,14,-161000,Fulton County,Fulton County-Suffolk County-MA
463,Fulton County-Orange County-CA-1516,"Orange County, CA",1516,2015,2016,224,15461000,178,11103000,46,4358000,Fulton County,Fulton County-Orange County-CA
464,Fulton County-Montgomery County-MD-1516,"Montgomery County, MD",1516,2015,2016,159,8954000,166,8137000,-7,817000,Fulton County,Fulton County-Montgomery County-MD
465,Fulton County-Prince George's County-MD-1516,"Prince George's County, MD",1516,2015,2016,158,5503000,126,2812000,32,2691000,Fulton County,Fulton County-Prince George's County-MD
466,Fulton County-Oakland County-MI-1516,"Oakland County, MI",1516,2015,2016,186,10189000,114,4729000,72,5460000,Fulton County,Fulton County-Oakland County-MI
467,Fulton County-Wayne County-MI-1516,"Wayne County, MI",1516,2015,2016,191,4253000,143,2686000,48,1567000,Fulton County,Fulton County-Wayne County-MI
468,Fulton County-Essex County-NJ-1516,"Essex County, NJ",1516,2015,2016,193,8131000,56,1703000,137,6428000,Fulton County,Fulton County-Essex County-NJ
469,Fulton County-Knox County-TN-1516,"Knox County, TN",1516,2015,2016,137,5622000,87,3248000,50,2374000,Fulton County,Fulton County-Knox County-TN
470,Fulton County-Orleans Parish-LA-1516,"Orleans Parish, LA",1516,2015,2016,153,4234000,142,3581000,11,653000,Fulton County,Fulton County-Orleans Parish-LA
471,Fulton County-Durham County-NC-1516,"Durham County, NC",1516,2015,2016,149,5852000,110,4531000,39,1321000,Fulton County,Fulton County-Durham County-NC
472,Fulton County-Hamilton County-OH-1516,"Hamilton County, OH",1516,2015,2016,160,7737000,104,3044000,56,4693000,Fulton County,Fulton County-Hamilton County-OH
473,Fulton County-Tarrant County-TX-1516,"Tarrant County, TX",1516,2015,2016,165,8864000,196,9120000,-31,-256000,Fulton County,Fulton County-Tarrant County-TX
474,Fulton County-Houston County-GA-1516,"Houston County, GA",1516,2015,2016,138,2910000,92,2021000,46,889000,Fulton County,Fulton County-Houston County-GA
475,Fulton County-Denver County-CO-1516,"Denver County, CO",1516,2015,2016,145,10585000,188,13730000,-43,-3145000,Fulton County,Fulton County-Denver County-CO
476,Fulton County-Suffolk County-NY-1516,"Suffolk County, NY",1516,2015,2016,169,6303000,57,1727000,112,4576000,Fulton County,Fulton County-Suffolk County-NY
477,Fulton County-Madison County-AL-1516,"Madison County, AL",1516,2015,2016,134,3731000,82,2023000,52,1708000,Fulton County,Fulton County-Madison County-AL
478,Fulton County-Bartow County-GA-1516,"Bartow County, GA",1516,2015,2016,139,4546000,130,3042000,9,1504000,Fulton County,Fulton County-Bartow County-GA
479,Fulton County-Bronx County-NY-1516,"Bronx County, NY",1516,2015,2016,144,2521000,59,590000,85,1931000,Fulton County,Fulton County-Bronx County-NY
480,Fulton County-Nassau County-NY-1516,"Nassau County, NY",1516,2015,2016,159,5991000,36,1474000,123,4517000,Fulton County,Fulton County-Nassau County-NY
481,Fulton County-Montgomery County-AL-1516,"Montgomery County, AL",1516,2015,2016,151,3107000,60,1378000,91,1729000,Fulton County,Fulton County-Montgomery County-AL
482,Fulton County-Hudson County-NJ-1516,"Hudson County, NJ",1516,2015,2016,149,8795000,108,5531000,41,3264000,Fulton County,Fulton County-Hudson County-NJ
483,Fulton County-San Francisco County-CA-1516,"San Francisco County, CA",1516,2015,2016,119,10584000,226,25599000,-107,-15015000,Fulton County,Fulton County-San Francisco County-CA
484,Fulton County-Santa Clara County-CA-1516,"Santa Clara County, CA",1516,2015,2016,168,10236000,249,15663000,-81,-5427000,Fulton County,Fulton County-Santa Clara County-CA
485,Fulton County-Baltimore city-MD-1516,"Baltimore city, MD",1516,2015,2016,137,5268000,83,2474000,54,2794000,Fulton County,Fulton County-Baltimore city-MD
486,Fulton County-Alachua County-FL-1516,"Alachua County, FL",1516,2015,2016,113,5327000,57,2159000,56,3168000,Fulton County,Fulton County-Alachua County-FL
487,Fulton County-Walton County-GA-1516,"Walton County, GA",1516,2015,2016,129,4241000,116,3080000,13,1161000,Fulton County,Fulton County-Walton County-GA
488,Fulton County-Clark County-NV-1516,"Clark County, NV",1516,2015,2016,132,7989000,151,11274000,-19,-3285000,Fulton County,Fulton County-Clark County-NV
489,Fulton County-Collin County-TX-1516,"Collin County, TX",1516,2015,2016,204,8127000,207,12018000,-3,-3891000,Fulton County,Fulton County-Collin County-TX
490,Fulton County-Columbia County-GA-1516,"Columbia County, GA",1516,2015,2016,139,6229000,73,2224000,66,4005000,Fulton County,Fulton County-Columbia County-GA
491,Fulton County-Dougherty County-GA-1516,"Dougherty County, GA",1516,2015,2016,124,2419000,65,1274000,59,1145000,Fulton County,Fulton County-Dougherty County-GA
492,Fulton County-St. Louis County-MO-1516,"St. Louis County, MO",1516,2015,2016,157,10634000,80,3265000,77,7369000,Fulton County,Fulton County-St. Louis County-MO
493,Fulton County-Westchester County-NY-1516,"Westchester County, NY",1516,2015,2016,185,7859000,54,3857000,131,4002000,Fulton County,Fulton County-Westchester County-NY
494,Fulton County-Marion County-IN-1516,"Marion County, IN",1516,2015,2016,126,3715000,88,3437000,38,278000,Fulton County,Fulton County-Marion County-IN
495,Fulton County-Middlesex County-NJ-1516,"Middlesex County, NJ",1516,2015,2016,192,7473000,101,3868000,91,3605000,Fulton County,Fulton County-Middlesex County-NJ
496,Fulton County-Bexar County-TX-1516,"Bexar County, TX",1516,2015,2016,142,5929000,111,2719000,31,3210000,Fulton County,Fulton County-Bexar County-TX
497,Fulton County-Milwaukee County-WI-1516,"Milwaukee County, WI",1516,2015,2016,121,3092000,55,1539000,66,1553000,Fulton County,Fulton County-Milwaukee County-WI
498,Fulton County-Troup County-GA-1516,"Troup County, GA",1516,2015,2016,124,3433000,63,1149000,61,2284000,Fulton County,Fulton County-Troup County-GA
499,Fulton County-Fairfield County-CT-1516,"Fairfield County, CT",1516,2015,2016,159,12667000,108,12774000,51,-107000,Fulton County,Fulton County-Fairfield County-CT
500,Fulton County-Seminole County-FL-1516,"Seminole County, FL",1516,2015,2016,108,5385000,80,2158000,28,3227000,Fulton County,Fulton County-Seminole County-FL
501,Fulton County-Jefferson County-KY-1516,"Jefferson County, KY",1516,2015,2016,124,6374000,90,7406000,34,-1032000,Fulton County,Fulton County-Jefferson County-KY
502,Fulton County-Henrico County-VA-1516,"Henrico County, VA",1516,2015,2016,147,6206000,54,2368000,93,3838000,Fulton County,Fulton County-Henrico County-VA
503,Fulton County-Spalding County-GA-1516,"Spalding County, GA",1516,2015,2016,135,2360000,165,3693000,-30,-1333000,Fulton County,Fulton County-Spalding County-GA
504,Fulton County-Guilford County-NC-1516,"Guilford County, NC",1516,2015,2016,110,4260000,52,2021000,58,2239000,Fulton County,Fulton County-Guilford County-NC
505,Fulton County-Mobile County-AL-1516,"Mobile County, AL",1516,2015,2016,118,3857000,61,1423000,57,2434000,Fulton County,Fulton County-Mobile County-AL
506,Fulton County-Shelby County-AL-1516,"Shelby County, AL",1516,2015,2016,120,8897000,69,3902000,51,4995000,Fulton County,Fulton County-Shelby County-AL
507,Fulton County-Lowndes County-GA-1516,"Lowndes County, GA",1516,2015,2016,105,1568000,69,1736000,36,-168000,Fulton County,Fulton County-Lowndes County-GA
508,Fulton County-Hartford County-CT-1516,"Hartford County, CT",1516,2015,2016,134,6434000,56,2158000,78,4276000,Fulton County,Fulton County-Hartford County-CT
509,Fulton County-Lee County-AL-1516,"Lee County, AL",1516,2015,2016,106,3128000,64,1860000,42,1268000,Fulton County,Fulton County-Lee County-AL
510,Fulton County-Arlington County-VA-1516,"Arlington County, VA",1516,2015,2016,92,7216000,99,6079000,-7,1137000,Fulton County,Fulton County-Arlington County-VA
511,Fulton County-DuPage County-IL-1516,"DuPage County, IL",1516,2015,2016,138,8407000,75,5919000,63,2488000,Fulton County,Fulton County-DuPage County-IL
512,Fulton County-Lake County-IL-1516,"Lake County, IL",1516,2015,2016,149,10736000,81,3234000,68,7502000,Fulton County,Fulton County-Lake County-IL
513,Fulton County-Erie County-NY-1516,"Erie County, NY",1516,2015,2016,112,2297000,37,1651000,75,646000,Fulton County,Fulton County-Erie County-NY
514,Fulton County-Escambia County-FL-1516,"Escambia County, FL",1516,2015,2016,92,2708000,85,2356000,7,352000,Fulton County,Fulton County-Escambia County-FL
515,Fulton County-Lee County-FL-1516,"Lee County, FL",1516,2015,2016,88,4215000,86,7042000,2,-2827000,Fulton County,Fulton County-Lee County-FL
516,Fulton County-Bulloch County-GA-1516,"Bulloch County, GA",1516,2015,2016,73,1599000,39,855000,34,744000,Fulton County,Fulton County-Bulloch County-GA
517,Fulton County-Richmond city-VA-1516,"Richmond city, VA",1516,2015,2016,88,3496000,51,2535000,37,961000,Fulton County,Fulton County-Richmond city-VA
518,Fulton County-Baltimore County-MD-1516,"Baltimore County, MD",1516,2015,2016,103,2663000,54,3542000,49,-879000,Fulton County,Fulton County-Baltimore County-MD
519,Fulton County-Montgomery County-PA-1516,"Montgomery County, PA",1516,2015,2016,94,6070000,43,3052000,51,3018000,Fulton County,Fulton County-Montgomery County-PA
520,Fulton County-New Haven County-CT-1516,"New Haven County, CT",1516,2015,2016,104,3205000,30,2239000,74,966000,Fulton County,Fulton County-New Haven County-CT
521,Fulton County-Volusia County-FL-1516,"Volusia County, FL",1516,2015,2016,72,2567000,73,5137000,-1,-2570000,Fulton County,Fulton County-Volusia County-FL
522,Fulton County-Glynn County-GA-1516,"Glynn County, GA",1516,2015,2016,72,2510000,127,6658000,-55,-4148000,Fulton County,Fulton County-Glynn County-GA
523,Fulton County-Forsyth County-NC-1516,"Forsyth County, NC",1516,2015,2016,86,2187000,69,4422000,17,-2235000,Fulton County,Fulton County-Forsyth County-NC
524,Fulton County-Contra Costa County-CA-1516,"Contra Costa County, CA",1516,2015,2016,118,17406000,72,3728000,46,13678000,Fulton County,Fulton County-Contra Costa County-CA
525,Fulton County-Beaufort County-SC-1516,"Beaufort County, SC",1516,2015,2016,85,4279000,99,18182000,-14,-13903000,Fulton County,Fulton County-Beaufort County-SC
526,Fulton County-New Castle County-DE-1516,"New Castle County, DE",1516,2015,2016,104,3029000,61,1218000,43,1811000,Fulton County,Fulton County-New Castle County-DE
527,Fulton County-Brevard County-FL-1516,"Brevard County, FL",1516,2015,2016,69,3351000,88,2946000,-19,405000,Fulton County,Fulton County-Brevard County-FL
528,Fulton County-Floyd County-GA-1516,"Floyd County, GA",1516,2015,2016,83,3340000,80,2524000,3,816000,Fulton County,Fulton County-Floyd County-GA
529,Fulton County-New Hanover County-NC-1516,"New Hanover County, NC",1516,2015,2016,73,2412000,35,1152000,38,1260000,Fulton County,Fulton County-New Hanover County-NC
530,Fulton County-Arapahoe County-CO-1516,"Arapahoe County, CO",1516,2015,2016,89,5768000,80,2607000,9,3161000,Fulton County,Fulton County-Arapahoe County-CO
531,Fulton County-Anne Arundel County-MD-1516,"Anne Arundel County, MD",1516,2015,2016,85,2575000,51,1381000,34,1194000,Fulton County,Fulton County-Anne Arundel County-MD
532,Fulton County-East Baton Rouge Parish-LA-1516,"East Baton Rouge Parish, LA",1516,2015,2016,66,1811000,55,1463000,11,348000,Fulton County,Fulton County-East Baton Rouge Parish-LA
533,Fulton County-Jackson County-MO-1516,"Jackson County, MO",1516,2015,2016,72,1986000,44,1543000,28,443000,Fulton County,Fulton County-Jackson County-MO
534,Fulton County-Barrow County-GA-1516,"Barrow County, GA",1516,2015,2016,67,2428000,89,2848000,-22,-420000,Fulton County,Fulton County-Barrow County-GA
535,Fulton County-Alexandria city-VA-1516,"Alexandria city, VA",1516,2015,2016,73,3850000,64,3925000,9,-75000,Fulton County,Fulton County-Alexandria city-VA
536,Fulton County-Dawson County-GA-1516,"Dawson County, GA",1516,2015,2016,78,2820000,121,8921000,-43,-6101000,Fulton County,Fulton County-Dawson County-GA
537,Fulton County-Polk County-FL-1516,"Polk County, FL",1516,2015,2016,78,2059000,75,1558000,3,501000,Fulton County,Fulton County-Polk County-FL
538,Fulton County-Cumberland County-NC-1516,"Cumberland County, NC",1516,2015,2016,90,1637000,58,851000,32,786000,Fulton County,Fulton County-Cumberland County-NC
539,Fulton County-Monroe County-NY-1516,"Monroe County, NY",1516,2015,2016,71,2721000,66,2339000,5,382000,Fulton County,Fulton County-Monroe County-NY
540,Fulton County-Virginia Beach city-VA-1516,"Virginia Beach city, VA",1516,2015,2016,74,2090000,48,1431000,26,659000,Fulton County,Fulton County-Virginia Beach city-VA
541,Fulton County-Bay County-FL-1516,"Bay County, FL",1516,2015,2016,62,3149000,61,2363000,1,786000,Fulton County,Fulton County-Bay County-FL
542,Fulton County-Jefferson Parish-LA-1516,"Jefferson Parish, LA",1516,2015,2016,68,1806000,71,2299000,-3,-493000,Fulton County,Fulton County-Jefferson Parish-LA
543,Fulton County-Morris County-NJ-1516,"Morris County, NJ",1516,2015,2016,86,9039000,45,2345000,41,6694000,Fulton County,Fulton County-Morris County-NJ
544,Fulton County-Denton County-TX-1516,"Denton County, TX",1516,2015,2016,89,5036000,113,6836000,-24,-1800000,Fulton County,Fulton County-Denton County-TX
545,Fulton County-St. Johns County-FL-1516,"St. Johns County, FL",1516,2015,2016,81,6230000,120,13864000,-39,-7634000,Fulton County,Fulton County-St. Johns County-FL
546,Fulton County-Buncombe County-NC-1516,"Buncombe County, NC",1516,2015,2016,61,2189000,102,5627000,-41,-3438000,Fulton County,Fulton County-Buncombe County-NC
547,Fulton County-Washtenaw County-MI-1516,"Washtenaw County, MI",1516,2015,2016,53,3295000,36,1124000,17,2171000,Fulton County,Fulton County-Washtenaw County-MI
548,Fulton County-St. Louis city-MO-1516,"St. Louis city, MO",1516,2015,2016,61,2678000,43,1645000,18,1033000,Fulton County,Fulton County-St. Louis city-MO
549,Fulton County-Sacramento County-CA-1516,"Sacramento County, CA",1516,2015,2016,75,3057000,86,1995000,-11,1062000,Fulton County,Fulton County-Sacramento County-CA
550,Fulton County-Prince William County-VA-1516,"Prince William County, VA",1516,2015,2016,67,2875000,57,1676000,10,1199000,Fulton County,Fulton County-Prince William County-VA
551,Fulton County-Norfolk city-VA-1516,"Norfolk city, VA",1516,2015,2016,67,1257000,40,921000,27,336000,Fulton County,Fulton County-Norfolk city-VA
552,Fulton County-Pulaski County-AR-1516,"Pulaski County, AR",1516,2015,2016,47,2112000,59,1223000,-12,889000,Fulton County,Fulton County-Pulaski County-AR
553,Fulton County-San Bernardino County-CA-1516,"San Bernardino County, CA",1516,2015,2016,68,1975000,63,968000,5,1007000,Fulton County,Fulton County-San Bernardino County-CA
554,Fulton County-Sarasota County-FL-1516,"Sarasota County, FL",1516,2015,2016,54,2502000,91,11607000,-37,-9105000,Fulton County,Fulton County-Sarasota County-FL
555,Fulton County-San Mateo County-CA-1516,"San Mateo County, CA",1516,2015,2016,74,5006000,83,6972000,-9,-1966000,Fulton County,Fulton County-San Mateo County-CA
556,Fulton County-Fayette County-KY-1516,"Fayette County, KY",1516,2015,2016,49,1772000,43,1936000,6,-164000,Fulton County,Fulton County-Fayette County-KY
557,Fulton County-Howard County-MD-1516,"Howard County, MD",1516,2015,2016,65,2432000,31,1093000,34,1339000,Fulton County,Fulton County-Howard County-MD
558,Fulton County-Montgomery County-OH-1516,"Montgomery County, OH",1516,2015,2016,69,2823000,53,1019000,16,1804000,Fulton County,Fulton County-Montgomery County-OH
559,Fulton County-Williamson County-TN-1516,"Williamson County, TN",1516,2015,2016,79,4125000,108,6479000,-29,-2354000,Fulton County,Fulton County-Williamson County-TN
560,Fulton County-Salt Lake County-UT-1516,"Salt Lake County, UT",1516,2015,2016,69,3140000,57,3240000,12,-100000,Fulton County,Fulton County-Salt Lake County-UT
561,Fulton County-Whitfield County-GA-1516,"Whitfield County, GA",1516,2015,2016,48,1423000,32,717000,16,706000,Fulton County,Fulton County-Whitfield County-GA
562,Fulton County-Dane County-WI-1516,"Dane County, WI",1516,2015,2016,60,1529000,39,912000,21,617000,Fulton County,Fulton County-Dane County-WI
563,Fulton County-Pickens County-GA-1516,"Pickens County, GA",1516,2015,2016,49,2935000,76,5301000,-27,-2366000,Fulton County,Fulton County-Pickens County-GA
564,Fulton County-Chester County-PA-1516,"Chester County, PA",1516,2015,2016,80,3852000,46,3340000,34,512000,Fulton County,Fulton County-Chester County-PA
565,Fulton County-Loudoun County-VA-1516,"Loudoun County, VA",1516,2015,2016,76,4114000,67,4290000,9,-176000,Fulton County,Fulton County-Loudoun County-VA
566,Fulton County-Orange County-NC-1516,"Orange County, NC",1516,2015,2016,37,1486000,58,2468000,-21,-982000,Fulton County,Fulton County-Orange County-NC
567,Fulton County-Multnomah County-OR-1516,"Multnomah County, OR",1516,2015,2016,41,3296000,91,4744000,-50,-1448000,Fulton County,Fulton County-Multnomah County-OR
568,Fulton County-Horry County-SC-1516,"Horry County, SC",1516,2015,2016,47,1022000,46,912000,1,110000,Fulton County,Fulton County-Horry County-SC
569,Fulton County-Benton County-AR-1516,"Benton County, AR",1516,2015,2016,69,4349000,45,4970000,24,-621000,Fulton County,Fulton County-Benton County-AR
570,Fulton County-Norfolk County-MA-1516,"Norfolk County, MA",1516,2015,2016,56,3984000,46,1984000,10,2000000,Fulton County,Fulton County-Norfolk County-MA
571,Fulton County-Meriwether County-GA-1516,"Meriwether County, GA",1516,2015,2016,46,819000,51,1406000,-5,-587000,Fulton County,Fulton County-Meriwether County-GA
572,Fulton County-Oconee County-GA-1516,"Oconee County, GA",1516,2015,2016,46,2200000,61,3236000,-15,-1036000,Fulton County,Fulton County-Oconee County-GA
573,Fulton County-El Paso County-CO-1516,"El Paso County, CO",1516,2015,2016,61,1689000,53,2053000,8,-364000,Fulton County,Fulton County-El Paso County-CO
574,Fulton County-Collier County-FL-1516,"Collier County, FL",1516,2015,2016,47,4471000,91,15929000,-44,-11458000,Fulton County,Fulton County-Collier County-FL
575,Fulton County-Delaware County-PA-1516,"Delaware County, PA",1516,2015,2016,69,2306000,35,2202000,34,104000,Fulton County,Fulton County-Delaware County-PA
576,Fulton County-Spartanburg County-SC-1516,"Spartanburg County, SC",1516,2015,2016,38,890000,36,1273000,2,-383000,Fulton County,Fulton County-Spartanburg County-SC
577,Fulton County-Williamson County-TX-1516,"Williamson County, TX",1516,2015,2016,67,2981000,44,1776000,23,1205000,Fulton County,Fulton County-Williamson County-TX
578,Fulton County-Riverside County-CA-1516,"Riverside County, CA",1516,2015,2016,44,1201000,81,2464000,-37,-1263000,Fulton County,Fulton County-Riverside County-CA
579,Fulton County-Lumpkin County-GA-1516,"Lumpkin County, GA",1516,2015,2016,38,1567000,53,1948000,-15,-381000,Fulton County,Fulton County-Lumpkin County-GA
580,Fulton County-Boulder County-CO-1516,"Boulder County, CO",1516,2015,2016,35,1843000,58,3852000,-23,-2009000,Fulton County,Fulton County-Boulder County-CO
581,Fulton County-Douglas County-CO-1516,"Douglas County, CO",1516,2015,2016,59,3655000,66,3064000,-7,591000,Fulton County,Fulton County-Douglas County-CO
582,Fulton County-Honolulu County-HI-1516,"Honolulu County, HI",1516,2015,2016,47,1455000,49,1774000,-2,-319000,Fulton County,Fulton County-Honolulu County-HI
583,Fulton County-Kent County-MI-1516,"Kent County, MI",1516,2015,2016,43,1144000,43,1418000,0,-274000,Fulton County,Fulton County-Kent County-MI
584,Fulton County-Fort Bend County-TX-1516,"Fort Bend County, TX",1516,2015,2016,59,2726000,101,4785000,-42,-2059000,Fulton County,Fulton County-Fort Bend County-TX
585,Fulton County-Bell County-TX-1516,"Bell County, TX",1516,2015,2016,40,500000,53,704000,-13,-204000,Fulton County,Fulton County-Bell County-TX
586,Fulton County-Manatee County-FL-1516,"Manatee County, FL",1516,2015,2016,41,1539000,79,6845000,-38,-5306000,Fulton County,Fulton County-Manatee County-FL
587,Fulton County-Pasco County-FL-1516,"Pasco County, FL",1516,2015,2016,49,1102000,44,1857000,5,-755000,Fulton County,Fulton County-Pasco County-FL
588,Fulton County-Greene County-GA-1516,"Greene County, GA",1516,2015,2016,37,1685000,59,6539000,-22,-4854000,Fulton County,Fulton County-Greene County-GA
589,Fulton County-Jackson County-GA-1516,"Jackson County, GA",1516,2015,2016,50,1141000,49,2015000,1,-874000,Fulton County,Fulton County-Jackson County-GA
590,Fulton County-Albany County-NY-1516,"Albany County, NY",1516,2015,2016,37,1266000,37,1065000,0,201000,Fulton County,Fulton County-Albany County-NY
591,Fulton County-Berkeley County-SC-1516,"Berkeley County, SC",1516,2015,2016,40,1289000,31,1003000,9,286000,Fulton County,Fulton County-Berkeley County-SC
592,Fulton County-St. Lucie County-FL-1516,"St. Lucie County, FL",1516,2015,2016,24,665000,45,1647000,-21,-982000,Fulton County,Fulton County-St. Lucie County-FL
593,Fulton County-Walton County-FL-1516,"Walton County, FL",1516,2015,2016,31,4000000,77,6944000,-46,-2944000,Fulton County,Fulton County-Walton County-FL
594,Fulton County-Pierce County-WA-1516,"Pierce County, WA",1516,2015,2016,43,1423000,40,1286000,3,137000,Fulton County,Fulton County-Pierce County-WA
596,Gwinnett County-DeKalb County-GA-1516,"DeKalb County, GA",1516,2015,2016,12252,235603000,8420,180734000,3832,54869000,Gwinnett County,Gwinnett County-DeKalb County-GA
597,Gwinnett County-Fulton County-GA-1516,"Fulton County, GA",1516,2015,2016,6623,181298000,5706,224199000,917,-42901000,Gwinnett County,Gwinnett County-Fulton County-GA
598,Gwinnett County-Cobb County-GA-1516,"Cobb County, GA",1516,2015,2016,2418,58574000,2223,58390000,195,184000,Gwinnett County,Gwinnett County-Cobb County-GA
599,Gwinnett County-Hall County-GA-1516,"Hall County, GA",1516,2015,2016,1620,44363000,2847,89947000,-1227,-45584000,Gwinnett County,Gwinnett County-Hall County-GA
600,Gwinnett County-Forsyth County-GA-1516,"Forsyth County, GA",1516,2015,2016,1358,47312000,2307,91533000,-949,-44221000,Gwinnett County,Gwinnett County-Forsyth County-GA
601,Gwinnett County-Barrow County-GA-1516,"Barrow County, GA",1516,2015,2016,1174,25779000,2323,52079000,-1149,-26300000,Gwinnett County,Gwinnett County-Barrow County-GA
602,Gwinnett County-Walton County-GA-1516,"Walton County, GA",1516,2015,2016,1053,21937000,2017,45322000,-964,-23385000,Gwinnett County,Gwinnett County-Walton County-GA
603,Gwinnett County-Clayton County-GA-1516,"Clayton County, GA",1516,2015,2016,907,12721000,812,10862000,95,1859000,Gwinnett County,Gwinnett County-Clayton County-GA
604,Gwinnett County-Rockdale County-GA-1516,"Rockdale County, GA",1516,2015,2016,536,11986000,570,9785000,-34,2201000,Gwinnett County,Gwinnett County-Rockdale County-GA
605,Gwinnett County-Broward County-FL-1516,"Broward County, FL",1516,2015,2016,536,10804000,430,11287000,106,-483000,Gwinnett County,Gwinnett County-Broward County-FL
606,Gwinnett County-Henry County-GA-1516,"Henry County, GA",1516,2015,2016,507,11945000,488,9063000,19,2882000,Gwinnett County,Gwinnett County-Henry County-GA
607,Gwinnett County-Cook County-IL-1516,"Cook County, IL",1516,2015,2016,576,10267000,230,5687000,346,4580000,Gwinnett County,Gwinnett County-Cook County-IL
608,Gwinnett County-Los Angeles County-CA-1516,"Los Angeles County, CA",1516,2015,2016,460,10713000,310,8893000,150,1820000,Gwinnett County,Gwinnett County-Los Angeles County-CA
609,Gwinnett County-Miami-Dade County-FL-1516,"Miami-Dade County, FL",1516,2015,2016,446,10437000,215,4052000,231,6385000,Gwinnett County,Gwinnett County-Miami-Dade County-FL
610,Gwinnett County-Cherokee County-GA-1516,"Cherokee County, GA",1516,2015,2016,401,10005000,658,19359000,-257,-9354000,Gwinnett County,Gwinnett County-Cherokee County-GA
611,Gwinnett County-Clarke County-GA-1516,"Clarke County, GA",1516,2015,2016,395,8715000,385,9800000,10,-1085000,Gwinnett County,Gwinnett County-Clarke County-GA
612,Gwinnett County-Queens County-NY-1516,"Queens County, NY",1516,2015,2016,435,7638000,152,2058000,283,5580000,Gwinnett County,Gwinnett County-Queens County-NY
613,Gwinnett County-Newton County-GA-1516,"Newton County, GA",1516,2015,2016,400,8086000,494,8409000,-94,-323000,Gwinnett County,Gwinnett County-Newton County-GA
614,Gwinnett County-Travis County-TX-1516,"Travis County, TX",1516,2015,2016,397,5532000,186,4203000,211,1329000,Gwinnett County,Gwinnett County-Travis County-TX
615,Gwinnett County-Kings County-NY-1516,"Kings County, NY",1516,2015,2016,382,5954000,161,2335000,221,3619000,Gwinnett County,Gwinnett County-Kings County-NY
616,Gwinnett County-Jackson County-GA-1516,"Jackson County, GA",1516,2015,2016,391,10864000,1102,33022000,-711,-22158000,Gwinnett County,Gwinnett County-Jackson County-GA
617,Gwinnett County-Douglas County-GA-1516,"Douglas County, GA",1516,2015,2016,354,6366000,315,5169000,39,1197000,Gwinnett County,Gwinnett County-Douglas County-GA
618,Gwinnett County-Bronx County-NY-1516,"Bronx County, NY",1516,2015,2016,324,4298000,88,716000,236,3582000,Gwinnett County,Gwinnett County-Bronx County-NY
619,Gwinnett County-Mecklenburg County-NC-1516,"Mecklenburg County, NC",1516,2015,2016,293,8352000,252,7518000,41,834000,Gwinnett County,Gwinnett County-Mecklenburg County-NC
620,Gwinnett County-Harris County-TX-1516,"Harris County, TX",1516,2015,2016,356,9362000,339,9256000,17,106000,Gwinnett County,Gwinnett County-Harris County-TX
621,Gwinnett County-Duval County-FL-1516,"Duval County, FL",1516,2015,2016,259,4699000,231,5838000,28,-1139000,Gwinnett County,Gwinnett County-Duval County-FL
622,Gwinnett County-Orange County-FL-1516,"Orange County, FL",1516,2015,2016,258,4697000,313,7026000,-55,-2329000,Gwinnett County,Gwinnett County-Orange County-FL
623,Gwinnett County-Chatham County-GA-1516,"Chatham County, GA",1516,2015,2016,211,4004000,202,5226000,9,-1222000,Gwinnett County,Gwinnett County-Chatham County-GA
624,Gwinnett County-Hillsborough County-FL-1516,"Hillsborough County, FL",1516,2015,2016,219,6637000,279,12042000,-60,-5405000,Gwinnett County,Gwinnett County-Hillsborough County-FL
625,Gwinnett County-Shelby County-TN-1516,"Shelby County, TN",1516,2015,2016,225,4534000,121,2849000,104,1685000,Gwinnett County,Gwinnett County-Shelby County-TN
626,Gwinnett County-Palm Beach County-FL-1516,"Palm Beach County, FL",1516,2015,2016,209,4537000,219,5260000,-10,-723000,Gwinnett County,Gwinnett County-Palm Beach County-FL
627,Gwinnett County-Muscogee County-GA-1516,"Muscogee County, GA",1516,2015,2016,192,3721000,115,3529000,77,192000,Gwinnett County,Gwinnett County-Muscogee County-GA
628,Gwinnett County-San Diego County-CA-1516,"San Diego County, CA",1516,2015,2016,199,4255000,103,2551000,96,1704000,Gwinnett County,Gwinnett County-San Diego County-CA
629,Gwinnett County-Richmond County-GA-1516,"Richmond County, GA",1516,2015,2016,158,3395000,84,1576000,74,1819000,Gwinnett County,Gwinnett County-Richmond County-GA
630,Gwinnett County-Dallas County-TX-1516,"Dallas County, TX",1516,2015,2016,202,4546000,265,6670000,-63,-2124000,Gwinnett County,Gwinnett County-Dallas County-TX
631,Gwinnett County-Wake County-NC-1516,"Wake County, NC",1516,2015,2016,196,6328000,137,4761000,59,1567000,Gwinnett County,Gwinnett County-Wake County-NC
632,Gwinnett County-Suffolk County-NY-1516,"Suffolk County, NY",1516,2015,2016,194,4332000,80,1233000,114,3099000,Gwinnett County,Gwinnett County-Suffolk County-NY
633,Gwinnett County-Davidson County-TN-1516,"Davidson County, TN",1516,2015,2016,147,3958000,134,6127000,13,-2169000,Gwinnett County,Gwinnett County-Davidson County-TN
634,Gwinnett County-Jefferson County-AL-1516,"Jefferson County, AL",1516,2015,2016,184,4322000,131,3191000,53,1131000,Gwinnett County,Gwinnett County-Jefferson County-AL
635,Gwinnett County-Maricopa County-AZ-1516,"Maricopa County, AZ",1516,2015,2016,179,4233000,191,5702000,-12,-1469000,Gwinnett County,Gwinnett County-Maricopa County-AZ
636,Gwinnett County-Nassau County-NY-1516,"Nassau County, NY",1516,2015,2016,171,2818000,41,656000,130,2162000,Gwinnett County,Gwinnett County-Nassau County-NY
637,Gwinnett County-Houston County-GA-1516,"Houston County, GA",1516,2015,2016,160,3889000,102,1667000,58,2222000,Gwinnett County,Gwinnett County-Houston County-GA
638,Gwinnett County-Pinellas County-FL-1516,"Pinellas County, FL",1516,2015,2016,150,3109000,137,3908000,13,-799000,Gwinnett County,Gwinnett County-Pinellas County-FL
639,Gwinnett County-Bibb County-GA-1516,"Bibb County, GA",1516,2015,2016,159,3916000,96,1714000,63,2202000,Gwinnett County,Gwinnett County-Bibb County-GA
640,Gwinnett County-Coweta County-GA-1516,"Coweta County, GA",1516,2015,2016,158,3590000,198,5919000,-40,-2329000,Gwinnett County,Gwinnett County-Coweta County-GA
641,Gwinnett County-Essex County-NJ-1516,"Essex County, NJ",1516,2015,2016,158,2376000,53,859000,105,1517000,Gwinnett County,Gwinnett County-Essex County-NJ
642,Gwinnett County-Tarrant County-TX-1516,"Tarrant County, TX",1516,2015,2016,134,3405000,148,3867000,-14,-462000,Gwinnett County,Gwinnett County-Tarrant County-TX
643,Gwinnett County-Prince George's County-MD-1516,"Prince George's County, MD",1516,2015,2016,148,3617000,84,1587000,64,2030000,Gwinnett County,Gwinnett County-Prince George's County-MD
644,Gwinnett County-Fayette County-GA-1516,"Fayette County, GA",1516,2015,2016,137,4163000,117,3515000,20,648000,Gwinnett County,Gwinnett County-Fayette County-GA
645,Gwinnett County-Orange County-CA-1516,"Orange County, CA",1516,2015,2016,148,2918000,148,8685000,0,-5767000,Gwinnett County,Gwinnett County-Orange County-CA
646,Gwinnett County-Paulding County-GA-1516,"Paulding County, GA",1516,2015,2016,113,2724000,236,5996000,-123,-3272000,Gwinnett County,Gwinnett County-Paulding County-GA
647,Gwinnett County-New York County-NY-1516,"New York County, NY",1516,2015,2016,114,4742000,92,3063000,22,1679000,Gwinnett County,Gwinnett County-New York County-NY
648,Gwinnett County-Greenville County-SC-1516,"Greenville County, SC",1516,2015,2016,145,3322000,153,3828000,-8,-506000,Gwinnett County,Gwinnett County-Greenville County-SC
649,Gwinnett County-Wayne County-MI-1516,"Wayne County, MI",1516,2015,2016,133,1957000,64,909000,69,1048000,Gwinnett County,Gwinnett County-Wayne County-MI
650,Gwinnett County-Franklin County-OH-1516,"Franklin County, OH",1516,2015,2016,131,3541000,93,1888000,38,1653000,Gwinnett County,Gwinnett County-Franklin County-OH
651,Gwinnett County-Richland County-SC-1516,"Richland County, SC",1516,2015,2016,128,2884000,92,2100000,36,784000,Gwinnett County,Gwinnett County-Richland County-SC
652,Gwinnett County-Dougherty County-GA-1516,"Dougherty County, GA",1516,2015,2016,147,2281000,41,685000,106,1596000,Gwinnett County,Gwinnett County-Dougherty County-GA
653,Gwinnett County-Clark County-NV-1516,"Clark County, NV",1516,2015,2016,138,2457000,161,3296000,-23,-839000,Gwinnett County,Gwinnett County-Clark County-NV
654,Gwinnett County-Fairfax County-VA-1516,"Fairfax County, VA",1516,2015,2016,124,5077000,122,3076000,2,2001000,Gwinnett County,Gwinnett County-Fairfax County-VA
655,Gwinnett County-Philadelphia County-PA-1516,"Philadelphia County, PA",1516,2015,2016,133,2099000,32,664000,101,1435000,Gwinnett County,Gwinnett County-Philadelphia County-PA
656,Gwinnett County-Mobile County-AL-1516,"Mobile County, AL",1516,2015,2016,116,2126000,46,627000,70,1499000,Gwinnett County,Gwinnett County-Mobile County-AL
657,Gwinnett County-Marion County-IN-1516,"Marion County, IN",1516,2015,2016,106,2103000,68,1127000,38,976000,Gwinnett County,Gwinnett County-Marion County-IN
658,Gwinnett County-Montgomery County-AL-1516,"Montgomery County, AL",1516,2015,2016,103,2371000,72,1075000,31,1296000,Gwinnett County,Gwinnett County-Montgomery County-AL
659,Gwinnett County-Middlesex County-NJ-1516,"Middlesex County, NJ",1516,2015,2016,119,2508000,55,1530000,64,978000,Gwinnett County,Gwinnett County-Middlesex County-NJ
660,Gwinnett County-Cuyahoga County-OH-1516,"Cuyahoga County, OH",1516,2015,2016,118,2525000,63,1017000,55,1508000,Gwinnett County,Gwinnett County-Cuyahoga County-OH
661,Gwinnett County-Bexar County-TX-1516,"Bexar County, TX",1516,2015,2016,101,2222000,101,2681000,0,-459000,Gwinnett County,Gwinnett County-Bexar County-TX
662,Gwinnett County-Madison County-AL-1516,"Madison County, AL",1516,2015,2016,83,3141000,61,1625000,22,1516000,Gwinnett County,Gwinnett County-Madison County-AL
663,Gwinnett County-Lowndes County-GA-1516,"Lowndes County, GA",1516,2015,2016,97,1598000,67,1208000,30,390000,Gwinnett County,Gwinnett County-Lowndes County-GA
664,Gwinnett County-Milwaukee County-WI-1516,"Milwaukee County, WI",1516,2015,2016,103,1638000,43,793000,60,845000,Gwinnett County,Gwinnett County-Milwaukee County-WI
665,Gwinnett County-Bulloch County-GA-1516,"Bulloch County, GA",1516,2015,2016,78,1407000,55,759000,23,648000,Gwinnett County,Gwinnett County-Bulloch County-GA
666,Gwinnett County-Lee County-FL-1516,"Lee County, FL",1516,2015,2016,98,1849000,111,4319000,-13,-2470000,Gwinnett County,Gwinnett County-Lee County-FL
667,Gwinnett County-Carroll County-GA-1516,"Carroll County, GA",1516,2015,2016,75,1472000,118,1769000,-43,-297000,Gwinnett County,Gwinnett County-Carroll County-GA
668,Gwinnett County-St. Louis County-MO-1516,"St. Louis County, MO",1516,2015,2016,123,2248000,57,1749000,66,499000,Gwinnett County,Gwinnett County-St. Louis County-MO
669,Gwinnett County-Guilford County-NC-1516,"Guilford County, NC",1516,2015,2016,110,1650000,79,1774000,31,-124000,Gwinnett County,Gwinnett County-Guilford County-NC
670,Gwinnett County-Leon County-FL-1516,"Leon County, FL",1516,2015,2016,75,1488000,63,1173000,12,315000,Gwinnett County,Gwinnett County-Leon County-FL
671,Gwinnett County-Middlesex County-MA-1516,"Middlesex County, MA",1516,2015,2016,99,2925000,55,2067000,44,858000,Gwinnett County,Gwinnett County-Middlesex County-MA
672,Gwinnett County-Baltimore County-MD-1516,"Baltimore County, MD",1516,2015,2016,104,2211000,39,767000,65,1444000,Gwinnett County,Gwinnett County-Baltimore County-MD
673,Gwinnett County-Montgomery County-MD-1516,"Montgomery County, MD",1516,2015,2016,93,2591000,80,2135000,13,456000,Gwinnett County,Gwinnett County-Montgomery County-MD
674,Gwinnett County-Hamilton County-TN-1516,"Hamilton County, TN",1516,2015,2016,77,2277000,112,4032000,-35,-1755000,Gwinnett County,Gwinnett County-Hamilton County-TN
675,Gwinnett County-Knox County-TN-1516,"Knox County, TN",1516,2015,2016,87,2713000,70,2079000,17,634000,Gwinnett County,Gwinnett County-Knox County-TN
676,Gwinnett County-Cumberland County-NC-1516,"Cumberland County, NC",1516,2015,2016,104,1490000,57,778000,47,712000,Gwinnett County,Gwinnett County-Cumberland County-NC
677,Gwinnett County-King County-WA-1516,"King County, WA",1516,2015,2016,93,2849000,165,6119000,-72,-3270000,Gwinnett County,Gwinnett County-King County-WA
678,Gwinnett County-Bartow County-GA-1516,"Bartow County, GA",1516,2015,2016,78,1952000,101,2453000,-23,-501000,Gwinnett County,Gwinnett County-Bartow County-GA
679,Gwinnett County-Alameda County-CA-1516,"Alameda County, CA",1516,2015,2016,77,2833000,59,1880000,18,953000,Gwinnett County,Gwinnett County-Alameda County-CA
680,Gwinnett County-Columbia County-GA-1516,"Columbia County, GA",1516,2015,2016,81,2061000,76,1548000,5,513000,Gwinnett County,Gwinnett County-Columbia County-GA
681,Gwinnett County-Bay County-FL-1516,"Bay County, FL",1516,2015,2016,81,1465000,85,2378000,-4,-913000,Gwinnett County,Gwinnett County-Bay County-FL
682,Gwinnett County-Oakland County-MI-1516,"Oakland County, MI",1516,2015,2016,93,1776000,50,1256000,43,520000,Gwinnett County,Gwinnett County-Oakland County-MI
683,Gwinnett County-Lee County-AL-1516,"Lee County, AL",1516,2015,2016,77,1227000,54,2276000,23,-1049000,Gwinnett County,Gwinnett County-Lee County-AL
684,Gwinnett County-Seminole County-FL-1516,"Seminole County, FL",1516,2015,2016,83,1622000,84,2344000,-1,-722000,Gwinnett County,Gwinnett County-Seminole County-FL
685,Gwinnett County-Polk County-FL-1516,"Polk County, FL",1516,2015,2016,75,1587000,116,1927000,-41,-340000,Gwinnett County,Gwinnett County-Polk County-FL
686,Gwinnett County-Hudson County-NJ-1516,"Hudson County, NJ",1516,2015,2016,78,1956000,39,1585000,39,371000,Gwinnett County,Gwinnett County-Hudson County-NJ
687,Gwinnett County-Virginia Beach city-VA-1516,"Virginia Beach city, VA",1516,2015,2016,82,1322000,59,1013000,23,309000,Gwinnett County,Gwinnett County-Virginia Beach city-VA
688,Gwinnett County-San Bernardino County-CA-1516,"San Bernardino County, CA",1516,2015,2016,90,2299000,48,868000,42,1431000,Gwinnett County,Gwinnett County-San Bernardino County-CA
689,Gwinnett County-Suffolk County-MA-1516,"Suffolk County, MA",1516,2015,2016,79,1674000,33,615000,46,1059000,Gwinnett County,Gwinnett County-Suffolk County-MA
690,Gwinnett County-Hennepin County-MN-1516,"Hennepin County, MN",1516,2015,2016,72,2881000,62,1205000,10,1676000,Gwinnett County,Gwinnett County-Hennepin County-MN
691,Gwinnett County-Riverside County-CA-1516,"Riverside County, CA",1516,2015,2016,91,2178000,64,1480000,27,698000,Gwinnett County,Gwinnett County-Riverside County-CA
692,Gwinnett County-Jefferson Parish-LA-1516,"Jefferson Parish, LA",1516,2015,2016,91,2229000,49,582000,42,1647000,Gwinnett County,Gwinnett County-Jefferson Parish-LA
693,Gwinnett County-Allegheny County-PA-1516,"Allegheny County, PA",1516,2015,2016,70,1693000,36,820000,34,873000,Gwinnett County,Gwinnett County-Allegheny County-PA
694,Gwinnett County-Volusia County-FL-1516,"Volusia County, FL",1516,2015,2016,64,1440000,89,3375000,-25,-1935000,Gwinnett County,Gwinnett County-Volusia County-FL
695,Gwinnett County-Shelby County-AL-1516,"Shelby County, AL",1516,2015,2016,68,2190000,50,1514000,18,676000,Gwinnett County,Gwinnett County-Shelby County-AL
696,Gwinnett County-Orleans Parish-LA-1516,"Orleans Parish, LA",1516,2015,2016,82,1080000,61,585000,21,495000,Gwinnett County,Gwinnett County-Orleans Parish-LA
697,Gwinnett County-Forsyth County-NC-1516,"Forsyth County, NC",1516,2015,2016,74,1267000,39,949000,35,318000,Gwinnett County,Gwinnett County-Forsyth County-NC
698,Gwinnett County-Charleston County-SC-1516,"Charleston County, SC",1516,2015,2016,74,1773000,98,3069000,-24,-1296000,Gwinnett County,Gwinnett County-Charleston County-SC
699,Gwinnett County-Brevard County-FL-1516,"Brevard County, FL",1516,2015,2016,80,3199000,79,3874000,1,-675000,Gwinnett County,Gwinnett County-Brevard County-FL
700,Gwinnett County-Anne Arundel County-MD-1516,"Anne Arundel County, MD",1516,2015,2016,82,1729000,46,996000,36,733000,Gwinnett County,Gwinnett County-Anne Arundel County-MD
701,Gwinnett County-El Paso County-CO-1516,"El Paso County, CO",1516,2015,2016,58,1318000,87,1910000,-29,-592000,Gwinnett County,Gwinnett County-El Paso County-CO
702,Gwinnett County-Oconee County-GA-1516,"Oconee County, GA",1516,2015,2016,59,2009000,151,7249000,-92,-5240000,Gwinnett County,Gwinnett County-Oconee County-GA
703,Gwinnett County-Horry County-SC-1516,"Horry County, SC",1516,2015,2016,58,827000,40,1511000,18,-684000,Gwinnett County,Gwinnett County-Horry County-SC
704,Gwinnett County-Pasco County-FL-1516,"Pasco County, FL",1516,2015,2016,64,1265000,83,1912000,-19,-647000,Gwinnett County,Gwinnett County-Pasco County-FL
705,Gwinnett County-Dawson County-GA-1516,"Dawson County, GA",1516,2015,2016,63,1393000,118,2963000,-55,-1570000,Gwinnett County,Gwinnett County-Dawson County-GA
706,Gwinnett County-Troup County-GA-1516,"Troup County, GA",1516,2015,2016,57,1506000,35,679000,22,827000,Gwinnett County,Gwinnett County-Troup County-GA
707,Gwinnett County-Osceola County-FL-1516,"Osceola County, FL",1516,2015,2016,61,858000,59,1072000,2,-214000,Gwinnett County,Gwinnett County-Osceola County-FL
708,Gwinnett County-Jefferson County-KY-1516,"Jefferson County, KY",1516,2015,2016,66,1350000,75,2073000,-9,-723000,Gwinnett County,Gwinnett County-Jefferson County-KY
709,Gwinnett County-Hamilton County-OH-1516,"Hamilton County, OH",1516,2015,2016,63,1489000,39,1007000,24,482000,Gwinnett County,Gwinnett County-Hamilton County-OH
710,Gwinnett County-Beaufort County-SC-1516,"Beaufort County, SC",1516,2015,2016,73,1027000,60,2412000,13,-1385000,Gwinnett County,Gwinnett County-Beaufort County-SC
711,Gwinnett County-Lexington County-SC-1516,"Lexington County, SC",1516,2015,2016,67,1351000,42,1310000,25,41000,Gwinnett County,Gwinnett County-Lexington County-SC
712,Gwinnett County-Rutherford County-TN-1516,"Rutherford County, TN",1516,2015,2016,60,1756000,45,1451000,15,305000,Gwinnett County,Gwinnett County-Rutherford County-TN
713,Gwinnett County-Collin County-TX-1516,"Collin County, TX",1516,2015,2016,69,1625000,151,4239000,-82,-2614000,Gwinnett County,Gwinnett County-Collin County-TX
714,Gwinnett County-Santa Clara County-CA-1516,"Santa Clara County, CA",1516,2015,2016,66,1934000,70,4124000,-4,-2190000,Gwinnett County,Gwinnett County-Santa Clara County-CA
715,Gwinnett County-Arapahoe County-CO-1516,"Arapahoe County, CO",1516,2015,2016,56,1160000,38,1111000,18,49000,Gwinnett County,Gwinnett County-Arapahoe County-CO
716,Gwinnett County-Lumpkin County-GA-1516,"Lumpkin County, GA",1516,2015,2016,52,703000,83,2482000,-31,-1779000,Gwinnett County,Gwinnett County-Lumpkin County-GA
717,Gwinnett County-Manatee County-FL-1516,"Manatee County, FL",1516,2015,2016,53,1524000,85,3380000,-32,-1856000,Gwinnett County,Gwinnett County-Manatee County-FL
718,Gwinnett County-Habersham County-GA-1516,"Habersham County, GA",1516,2015,2016,52,1354000,74,1541000,-22,-187000,Gwinnett County,Gwinnett County-Habersham County-GA
719,Gwinnett County-District of Columbia-DC-1516,"District of Columbia, DC",1516,2015,2016,46,1146000,48,1473000,-2,-327000,Gwinnett County,Gwinnett County-District of Columbia-DC
720,Gwinnett County-Sarasota County-FL-1516,"Sarasota County, FL",1516,2015,2016,49,1043000,55,2250000,-6,-1207000,Gwinnett County,Gwinnett County-Sarasota County-FL
721,Gwinnett County-Honolulu County-HI-1516,"Honolulu County, HI",1516,2015,2016,53,796000,53,1256000,0,-460000,Gwinnett County,Gwinnett County-Honolulu County-HI
722,Gwinnett County-Baltimore city-MD-1516,"Baltimore city, MD",1516,2015,2016,50,943000,40,697000,10,246000,Gwinnett County,Gwinnett County-Baltimore city-MD
723,Gwinnett County-Durham County-NC-1516,"Durham County, NC",1516,2015,2016,57,1793000,42,975000,15,818000,Gwinnett County,Gwinnett County-Durham County-NC
724,Gwinnett County-Spartanburg County-SC-1516,"Spartanburg County, SC",1516,2015,2016,61,1455000,40,1014000,21,441000,Gwinnett County,Gwinnett County-Spartanburg County-SC
725,Gwinnett County-Denton County-TX-1516,"Denton County, TX",1516,2015,2016,50,1247000,99,3161000,-49,-1914000,Gwinnett County,Gwinnett County-Denton County-TX
726,Gwinnett County-Fort Bend County-TX-1516,"Fort Bend County, TX",1516,2015,2016,51,865000,78,1757000,-27,-892000,Gwinnett County,Gwinnett County-Fort Bend County-TX
727,Gwinnett County-Chesterfield County-VA-1516,"Chesterfield County, VA",1516,2015,2016,65,3707000,38,847000,27,2860000,Gwinnett County,Gwinnett County-Chesterfield County-VA
728,Gwinnett County-Escambia County-FL-1516,"Escambia County, FL",1516,2015,2016,49,1158000,61,1647000,-12,-489000,Gwinnett County,Gwinnett County-Escambia County-FL
729,Gwinnett County-Okaloosa County-FL-1516,"Okaloosa County, FL",1516,2015,2016,45,727000,73,3305000,-28,-2578000,Gwinnett County,Gwinnett County-Okaloosa County-FL
730,Gwinnett County-Sacramento County-CA-1516,"Sacramento County, CA",1516,2015,2016,59,1183000,61,1522000,-2,-339000,Gwinnett County,Gwinnett County-Sacramento County-CA
731,Gwinnett County-St. Lucie County-FL-1516,"St. Lucie County, FL",1516,2015,2016,47,713000,59,1687000,-12,-974000,Gwinnett County,Gwinnett County-St. Lucie County-FL
732,Gwinnett County-Floyd County-GA-1516,"Floyd County, GA",1516,2015,2016,39,876000,58,956000,-19,-80000,Gwinnett County,Gwinnett County-Floyd County-GA
733,Gwinnett County-White County-GA-1516,"White County, GA",1516,2015,2016,35,837000,73,2855000,-38,-2018000,Gwinnett County,Gwinnett County-White County-GA
734,Gwinnett County-East Baton Rouge Parish-LA-1516,"East Baton Rouge Parish, LA",1516,2015,2016,52,1108000,52,800000,0,308000,Gwinnett County,Gwinnett County-East Baton Rouge Parish-LA
735,Gwinnett County-Berkeley County-SC-1516,"Berkeley County, SC",1516,2015,2016,35,751000,54,1945000,-19,-1194000,Gwinnett County,Gwinnett County-Berkeley County-SC
736,Gwinnett County-Denver County-CO-1516,"Denver County, CO",1516,2015,2016,36,1203000,52,1589000,-16,-386000,Gwinnett County,Gwinnett County-Denver County-CO
737,Gwinnett County-Clay County-FL-1516,"Clay County, FL",1516,2015,2016,51,1146000,36,719000,15,427000,Gwinnett County,Gwinnett County-Clay County-FL
738,Gwinnett County-Spalding County-GA-1516,"Spalding County, GA",1516,2015,2016,39,899000,50,793000,-11,106000,Gwinnett County,Gwinnett County-Spalding County-GA
739,Gwinnett County-Anderson County-SC-1516,"Anderson County, SC",1516,2015,2016,37,1348000,40,969000,-3,379000,Gwinnett County,Gwinnett County-Anderson County-SC
740,Gwinnett County-Madison County-GA-1516,"Madison County, GA",1516,2015,2016,42,589000,55,1487000,-13,-898000,Gwinnett County,Gwinnett County-Madison County-GA
741,Gwinnett County-Onslow County-NC-1516,"Onslow County, NC",1516,2015,2016,50,1018000,38,812000,12,206000,Gwinnett County,Gwinnett County-Onslow County-NC
743,Henry County-Clayton County-GA-1516,"Clayton County, GA",1516,2015,2016,4215,68038000,2704,38398000,1511,29640000,Henry County,Henry County-Clayton County-GA
744,Henry County-DeKalb County-GA-1516,"DeKalb County, GA",1516,2015,2016,1532,28161000,860,19062000,672,9099000,Henry County,Henry County-DeKalb County-GA
745,Henry County-Fulton County-GA-1516,"Fulton County, GA",1516,2015,2016,1255,25608000,1064,35711000,191,-10103000,Henry County,Henry County-Fulton County-GA
746,Henry County-Spalding County-GA-1516,"Spalding County, GA",1516,2015,2016,588,9049000,761,12896000,-173,-3847000,Henry County,Henry County-Spalding County-GA
747,Henry County-Gwinnett County-GA-1516,"Gwinnett County, GA",1516,2015,2016,488,9063000,507,11945000,-19,-2882000,Henry County,Henry County-Gwinnett County-GA
748,Henry County-Cobb County-GA-1516,"Cobb County, GA",1516,2015,2016,343,6763000,520,14003000,-177,-7240000,Henry County,Henry County-Cobb County-GA
749,Henry County-Newton County-GA-1516,"Newton County, GA",1516,2015,2016,409,6822000,338,6189000,71,633000,Henry County,Henry County-Newton County-GA
750,Henry County-Rockdale County-GA-1516,"Rockdale County, GA",1516,2015,2016,354,6723000,280,5042000,74,1681000,Henry County,Henry County-Rockdale County-GA
751,Henry County-Butts County-GA-1516,"Butts County, GA",1516,2015,2016,323,5414000,466,10542000,-143,-5128000,Henry County,Henry County-Butts County-GA
752,Henry County-Fayette County-GA-1516,"Fayette County, GA",1516,2015,2016,250,5327000,374,10711000,-124,-5384000,Henry County,Henry County-Fayette County-GA
753,Henry County-Bibb County-GA-1516,"Bibb County, GA",1516,2015,2016,234,5898000,144,2739000,90,3159000,Henry County,Henry County-Bibb County-GA
754,Henry County-Broward County-FL-1516,"Broward County, FL",1516,2015,2016,181,3185000,70,1723000,111,1462000,Henry County,Henry County-Broward County-FL
755,Henry County-Coweta County-GA-1516,"Coweta County, GA",1516,2015,2016,129,3093000,347,11759000,-218,-8666000,Henry County,Henry County-Coweta County-GA
756,Henry County-Douglas County-GA-1516,"Douglas County, GA",1516,2015,2016,160,2794000,124,2011000,36,783000,Henry County,Henry County-Douglas County-GA
757,Henry County-Miami-Dade County-FL-1516,"Miami-Dade County, FL",1516,2015,2016,112,2028000,57,981000,55,1047000,Henry County,Henry County-Miami-Dade County-FL
758,Henry County-Houston County-GA-1516,"Houston County, GA",1516,2015,2016,125,3173000,52,1011000,73,2162000,Henry County,Henry County-Houston County-GA
759,Henry County-Muscogee County-GA-1516,"Muscogee County, GA",1516,2015,2016,98,2230000,52,794000,46,1436000,Henry County,Henry County-Muscogee County-GA
760,Henry County-Duval County-FL-1516,"Duval County, FL",1516,2015,2016,94,1585000,54,1243000,40,342000,Henry County,Henry County-Duval County-FL
761,Henry County-Chatham County-GA-1516,"Chatham County, GA",1516,2015,2016,81,1337000,48,1005000,33,332000,Henry County,Henry County-Chatham County-GA
762,Henry County-Lamar County-GA-1516,"Lamar County, GA",1516,2015,2016,77,1409000,90,2243000,-13,-834000,Henry County,Henry County-Lamar County-GA
763,Henry County-Orange County-FL-1516,"Orange County, FL",1516,2015,2016,69,1358000,65,1113000,4,245000,Henry County,Henry County-Orange County-FL
764,Henry County-Jefferson County-AL-1516,"Jefferson County, AL",1516,2015,2016,62,1488000,39,843000,23,645000,Henry County,Henry County-Jefferson County-AL
765,Henry County-Paulding County-GA-1516,"Paulding County, GA",1516,2015,2016,80,1103000,76,1555000,4,-452000,Henry County,Henry County-Paulding County-GA
766,Henry County-Monroe County-GA-1516,"Monroe County, GA",1516,2015,2016,53,1101000,127,2949000,-74,-1848000,Henry County,Henry County-Monroe County-GA
767,Henry County-Carroll County-GA-1516,"Carroll County, GA",1516,2015,2016,43,912000,60,786000,-17,126000,Henry County,Henry County-Carroll County-GA
768,Henry County-Jasper County-GA-1516,"Jasper County, GA",1516,2015,2016,46,779000,74,2226000,-28,-1447000,Henry County,Henry County-Jasper County-GA
769,Henry County-Harris County-TX-1516,"Harris County, TX",1516,2015,2016,42,785000,52,1227000,-10,-442000,Henry County,Henry County-Harris County-TX
770,Henry County-Hillsborough County-FL-1516,"Hillsborough County, FL",1516,2015,2016,43,810000,49,2618000,-6,-1808000,Henry County,Henry County-Hillsborough County-FL
771,Henry County-Cherokee County-GA-1516,"Cherokee County, GA",1516,2015,2016,59,1253000,85,2568000,-26,-1315000,Henry County,Henry County-Cherokee County-GA
772,Henry County-Pike County-GA-1516,"Pike County, GA",1516,2015,2016,46,765000,115,2402000,-69,-1637000,Henry County,Henry County-Pike County-GA
773,Henry County-Mecklenburg County-NC-1516,"Mecklenburg County, NC",1516,2015,2016,47,877000,37,1267000,10,-390000,Henry County,Henry County-Mecklenburg County-NC
774,Henry County-Forsyth County-GA-1516,"Forsyth County, GA",1516,2015,2016,44,1373000,109,3152000,-65,-1779000,Henry County,Henry County-Forsyth County-GA
775,Henry County-Upson County-GA-1516,"Upson County, GA",1516,2015,2016,43,618000,55,1037000,-12,-419000,Henry County,Henry County-Upson County-GA
777,Rockdale County-DeKalb County-GA-1516,"DeKalb County, GA",1516,2015,2016,1784,28590000,1056,16042000,728,12548000,Rockdale County,Rockdale County-DeKalb County-GA
778,Rockdale County-Newton County-GA-1516,"Newton County, GA",1516,2015,2016,1202,15942000,1631,25533000,-429,-9591000,Rockdale County,Rockdale County-Newton County-GA
779,Rockdale County-Gwinnett County-GA-1516,"Gwinnett County, GA",1516,2015,2016,570,9785000,536,11986000,34,-2201000,Rockdale County,Rockdale County-Gwinnett County-GA
780,Rockdale County-Fulton County-GA-1516,"Fulton County, GA",1516,2015,2016,300,6804000,414,10213000,-114,-3409000,Rockdale County,Rockdale County-Fulton County-GA
781,Rockdale County-Henry County-GA-1516,"Henry County, GA",1516,2015,2016,280,5042000,354,6723000,-74,-1681000,Rockdale County,Rockdale County-Henry County-GA
782,Rockdale County-Clayton County-GA-1516,"Clayton County, GA",1516,2015,2016,247,3444000,203,2603000,44,841000,Rockdale County,Rockdale County-Clayton County-GA
783,Rockdale County-Walton County-GA-1516,"Walton County, GA",1516,2015,2016,195,3110000,275,5822000,-80,-2712000,Rockdale County,Rockdale County-Walton County-GA
784,Rockdale County-Cobb County-GA-1516,"Cobb County, GA",1516,2015,2016,149,2985000,179,4065000,-30,-1080000,Rockdale County,Rockdale County-Cobb County-GA
785,Rockdale County-Broward County-FL-1516,"Broward County, FL",1516,2015,2016,54,1064000,45,770000,9,294000,Rockdale County,Rockdale County-Broward County-FL
786,Rockdale County-Jasper County-GA-1516,"Jasper County, GA",1516,2015,2016,46,858000,44,949000,2,-91000,Rockdale County,Rockdale County-Jasper County-GA
788,Cherokee County-Cobb County-GA-1617,"Cobb County, GA",1617,2016,2017,6649,235644000,3751,120165000,2898,115479000,Cherokee County,Cherokee County-Cobb County-GA
789,Cherokee County-Fulton County-GA-1617,"Fulton County, GA",1617,2016,2017,3257,108232000,1631,78826000,1626,29406000,Cherokee County,Cherokee County-Fulton County-GA
790,Cherokee County-Forsyth County-GA-1617,"Forsyth County, GA",1617,2016,2017,1027,43405000,784,30843000,243,12562000,Cherokee County,Cherokee County-Forsyth County-GA
791,Cherokee County-Gwinnett County-GA-1617,"Gwinnett County, GA",1617,2016,2017,860,27673000,497,13785000,363,13888000,Cherokee County,Cherokee County-Gwinnett County-GA
792,Cherokee County-DeKalb County-GA-1617,"DeKalb County, GA",1617,2016,2017,547,20140000,291,9930000,256,10210000,Cherokee County,Cherokee County-DeKalb County-GA
793,Cherokee County-Pickens County-GA-1617,"Pickens County, GA",1617,2016,2017,663,16413000,1089,31340000,-426,-14927000,Cherokee County,Cherokee County-Pickens County-GA
794,Cherokee County-Bartow County-GA-1617,"Bartow County, GA",1617,2016,2017,643,13892000,1042,27297000,-399,-13405000,Cherokee County,Cherokee County-Bartow County-GA
795,Cherokee County-Paulding County-GA-1617,"Paulding County, GA",1617,2016,2017,556,17002000,733,16867000,-177,135000,Cherokee County,Cherokee County-Paulding County-GA
796,Cherokee County-Henry County-GA-1617,"Henry County, GA",1617,2016,2017,208,6324000,65,1391000,143,4933000,Cherokee County,Cherokee County-Henry County-GA
797,Cherokee County-Douglas County-GA-1617,"Douglas County, GA",1617,2016,2017,174,5973000,63,2151000,111,3822000,Cherokee County,Cherokee County-Douglas County-GA
798,Cherokee County-Broward County-FL-1617,"Broward County, FL",1617,2016,2017,172,5001000,72,2645000,100,2356000,Cherokee County,Cherokee County-Broward County-FL
799,Cherokee County-Palm Beach County-FL-1617,"Palm Beach County, FL",1617,2016,2017,146,3687000,91,5541000,55,-1854000,Cherokee County,Cherokee County-Palm Beach County-FL
800,Cherokee County-Miami-Dade County-FL-1617,"Miami-Dade County, FL",1617,2016,2017,154,2792000,35,612000,119,2180000,Cherokee County,Cherokee County-Miami-Dade County-FL
801,Cherokee County-Gilmer County-GA-1617,"Gilmer County, GA",1617,2016,2017,116,2376000,244,7325000,-128,-4949000,Cherokee County,Cherokee County-Gilmer County-GA
802,Cherokee County-Coweta County-GA-1617,"Coweta County, GA",1617,2016,2017,121,4346000,100,3497000,21,849000,Cherokee County,Cherokee County-Coweta County-GA
803,Cherokee County-Hall County-GA-1617,"Hall County, GA",1617,2016,2017,102,3340000,171,5311000,-69,-1971000,Cherokee County,Cherokee County-Hall County-GA
804,Cherokee County-Duval County-FL-1617,"Duval County, FL",1617,2016,2017,91,3713000,59,1072000,32,2641000,Cherokee County,Cherokee County-Duval County-FL
805,Cherokee County-Fayette County-GA-1617,"Fayette County, GA",1617,2016,2017,79,3550000,58,1714000,21,1836000,Cherokee County,Cherokee County-Fayette County-GA
806,Cherokee County-Chatham County-GA-1617,"Chatham County, GA",1617,2016,2017,96,2706000,48,2036000,48,670000,Cherokee County,Cherokee County-Chatham County-GA
807,Cherokee County-Dawson County-GA-1617,"Dawson County, GA",1617,2016,2017,89,2789000,112,2357000,-23,432000,Cherokee County,Cherokee County-Dawson County-GA
808,Cherokee County-Maricopa County-AZ-1617,"Maricopa County, AZ",1617,2016,2017,99,5930000,79,2679000,20,3251000,Cherokee County,Cherokee County-Maricopa County-AZ
809,Cherokee County-Hillsborough County-FL-1617,"Hillsborough County, FL",1617,2016,2017,76,2607000,84,4268000,-8,-1661000,Cherokee County,Cherokee County-Hillsborough County-FL
810,Cherokee County-Orange County-FL-1617,"Orange County, FL",1617,2016,2017,86,2328000,64,1890000,22,438000,Cherokee County,Cherokee County-Orange County-FL
811,Cherokee County-Carroll County-GA-1617,"Carroll County, GA",1617,2016,2017,70,1852000,47,1333000,23,519000,Cherokee County,Cherokee County-Carroll County-GA
812,Cherokee County-Clarke County-GA-1617,"Clarke County, GA",1617,2016,2017,58,1418000,36,802000,22,616000,Cherokee County,Cherokee County-Clarke County-GA
813,Cherokee County-Floyd County-GA-1617,"Floyd County, GA",1617,2016,2017,66,3108000,104,2775000,-38,333000,Cherokee County,Cherokee County-Floyd County-GA
814,Cherokee County-Hamilton County-TN-1617,"Hamilton County, TN",1617,2016,2017,72,2894000,50,2020000,22,874000,Cherokee County,Cherokee County-Hamilton County-TN
815,Cherokee County-Pinellas County-FL-1617,"Pinellas County, FL",1617,2016,2017,68,1690000,81,2695000,-13,-1005000,Cherokee County,Cherokee County-Pinellas County-FL
816,Cherokee County-Wake County-NC-1617,"Wake County, NC",1617,2016,2017,78,2618000,49,2148000,29,470000,Cherokee County,Cherokee County-Wake County-NC
817,Cherokee County-Clayton County-GA-1617,"Clayton County, GA",1617,2016,2017,64,1325000,51,822000,13,503000,Cherokee County,Cherokee County-Clayton County-GA
818,Cherokee County-Mecklenburg County-NC-1617,"Mecklenburg County, NC",1617,2016,2017,56,2062000,45,2216000,11,-154000,Cherokee County,Cherokee County-Mecklenburg County-NC
819,Cherokee County-Newton County-GA-1617,"Newton County, GA",1617,2016,2017,57,1573000,48,1070000,9,503000,Cherokee County,Cherokee County-Newton County-GA
820,Cherokee County-Tarrant County-TX-1617,"Tarrant County, TX",1617,2016,2017,61,1927000,51,1862000,10,65000,Cherokee County,Cherokee County-Tarrant County-TX
821,Cherokee County-Harris County-TX-1617,"Harris County, TX",1617,2016,2017,65,2076000,49,1184000,16,892000,Cherokee County,Cherokee County-Harris County-TX
822,Cherokee County-Knox County-TN-1617,"Knox County, TN",1617,2016,2017,58,2252000,40,1566000,18,686000,Cherokee County,Cherokee County-Knox County-TN
823,Cherokee County-Walton County-GA-1617,"Walton County, GA",1617,2016,2017,60,1896000,49,1158000,11,738000,Cherokee County,Cherokee County-Walton County-GA
824,Cherokee County-Seminole County-FL-1617,"Seminole County, FL",1617,2016,2017,51,1349000,51,1388000,0,-39000,Cherokee County,Cherokee County-Seminole County-FL
825,Cherokee County-Fannin County-GA-1617,"Fannin County, GA",1617,2016,2017,41,1287000,79,3689000,-38,-2402000,Cherokee County,Cherokee County-Fannin County-GA
826,Cherokee County-Gordon County-GA-1617,"Gordon County, GA",1617,2016,2017,53,1311000,110,2346000,-57,-1035000,Cherokee County,Cherokee County-Gordon County-GA
827,Cherokee County-Lee County-FL-1617,"Lee County, FL",1617,2016,2017,43,1738000,44,1667000,-1,71000,Cherokee County,Cherokee County-Lee County-FL
828,Cherokee County-Clark County-NV-1617,"Clark County, NV",1617,2016,2017,38,1124000,43,1221000,-5,-97000,Cherokee County,Cherokee County-Clark County-NV
829,Cherokee County-Charleston County-SC-1617,"Charleston County, SC",1617,2016,2017,38,1612000,43,1876000,-5,-264000,Cherokee County,Cherokee County-Charleston County-SC
830,Cherokee County-Jefferson County-AL-1617,"Jefferson County, AL",1617,2016,2017,39,1104000,41,1912000,-2,-808000,Cherokee County,Cherokee County-Jefferson County-AL
831,Cherokee County-Brevard County-FL-1617,"Brevard County, FL",1617,2016,2017,35,1215000,52,2223000,-17,-1008000,Cherokee County,Cherokee County-Brevard County-FL
833,Clayton County-Fulton County-GA-1617,"Fulton County, GA",1617,2016,2017,8445,98837000,7239,94527000,1206,4310000,Clayton County,Clayton County-Fulton County-GA
834,Clayton County-DeKalb County-GA-1617,"DeKalb County, GA",1617,2016,2017,4102,50678000,2957,39627000,1145,11051000,Clayton County,Clayton County-DeKalb County-GA
835,Clayton County-Henry County-GA-1617,"Henry County, GA",1617,2016,2017,3125,46308000,5981,103103000,-2856,-56795000,Clayton County,Clayton County-Henry County-GA
836,Clayton County-Cobb County-GA-1617,"Cobb County, GA",1617,2016,2017,1151,17529000,1054,17839000,97,-310000,Clayton County,Clayton County-Cobb County-GA
837,Clayton County-Gwinnett County-GA-1617,"Gwinnett County, GA",1617,2016,2017,1037,14893000,1157,18633000,-120,-3740000,Clayton County,Clayton County-Gwinnett County-GA
838,Clayton County-Fayette County-GA-1617,"Fayette County, GA",1617,2016,2017,594,8968000,1409,26502000,-815,-17534000,Clayton County,Clayton County-Fayette County-GA
839,Clayton County-Douglas County-GA-1617,"Douglas County, GA",1617,2016,2017,430,5262000,451,6553000,-21,-1291000,Clayton County,Clayton County-Douglas County-GA
840,Clayton County-Spalding County-GA-1617,"Spalding County, GA",1617,2016,2017,435,4927000,643,8415000,-208,-3488000,Clayton County,Clayton County-Spalding County-GA
841,Clayton County-Miami-Dade County-FL-1617,"Miami-Dade County, FL",1617,2016,2017,361,4023000,62,667000,299,3356000,Clayton County,Clayton County-Miami-Dade County-FL
842,Clayton County-Cook County-IL-1617,"Cook County, IL",1617,2016,2017,285,3415000,90,1015000,195,2400000,Clayton County,Clayton County-Cook County-IL
843,Clayton County-Coweta County-GA-1617,"Coweta County, GA",1617,2016,2017,281,4276000,403,7054000,-122,-2778000,Clayton County,Clayton County-Coweta County-GA
844,Clayton County-Kings County-NY-1617,"Kings County, NY",1617,2016,2017,221,3447000,52,860000,169,2587000,Clayton County,Clayton County-Kings County-NY
845,Clayton County-Broward County-FL-1617,"Broward County, FL",1617,2016,2017,244,2659000,103,1222000,141,1437000,Clayton County,Clayton County-Broward County-FL
846,Clayton County-Bibb County-GA-1617,"Bibb County, GA",1617,2016,2017,216,2535000,125,1237000,91,1298000,Clayton County,Clayton County-Bibb County-GA
847,Clayton County-Newton County-GA-1617,"Newton County, GA",1617,2016,2017,207,2469000,273,3577000,-66,-1108000,Clayton County,Clayton County-Newton County-GA
848,Clayton County-Chatham County-GA-1617,"Chatham County, GA",1617,2016,2017,174,2377000,95,1512000,79,865000,Clayton County,Clayton County-Chatham County-GA
849,Clayton County-Rockdale County-GA-1617,"Rockdale County, GA",1617,2016,2017,202,2559000,286,4532000,-84,-1973000,Clayton County,Clayton County-Rockdale County-GA
850,Clayton County-Muscogee County-GA-1617,"Muscogee County, GA",1617,2016,2017,160,1758000,148,1495000,12,263000,Clayton County,Clayton County-Muscogee County-GA
851,Clayton County-Los Angeles County-CA-1617,"Los Angeles County, CA",1617,2016,2017,139,2023000,53,1257000,86,766000,Clayton County,Clayton County-Los Angeles County-CA
852,Clayton County-Orange County-FL-1617,"Orange County, FL",1617,2016,2017,124,1850000,118,1506000,6,344000,Clayton County,Clayton County-Orange County-FL
853,Clayton County-Queens County-NY-1617,"Queens County, NY",1617,2016,2017,131,2041000,51,663000,80,1378000,Clayton County,Clayton County-Queens County-NY
854,Clayton County-Richmond County-GA-1617,"Richmond County, GA",1617,2016,2017,130,1895000,77,938000,53,957000,Clayton County,Clayton County-Richmond County-GA
855,Clayton County-Prince George's County-MD-1617,"Prince George's County, MD",1617,2016,2017,100,2394000,38,706000,62,1688000,Clayton County,Clayton County-Prince George's County-MD
856,Clayton County-Dougherty County-GA-1617,"Dougherty County, GA",1617,2016,2017,122,1331000,79,739000,43,592000,Clayton County,Clayton County-Dougherty County-GA
857,Clayton County-Jefferson County-AL-1617,"Jefferson County, AL",1617,2016,2017,121,1898000,60,831000,61,1067000,Clayton County,Clayton County-Jefferson County-AL
858,Clayton County-Duval County-FL-1617,"Duval County, FL",1617,2016,2017,95,1065000,128,1418000,-33,-353000,Clayton County,Clayton County-Duval County-FL
859,Clayton County-Harris County-TX-1617,"Harris County, TX",1617,2016,2017,93,1244000,118,1764000,-25,-520000,Clayton County,Clayton County-Harris County-TX
860,Clayton County-Wayne County-MI-1617,"Wayne County, MI",1617,2016,2017,114,1366000,65,783000,49,583000,Clayton County,Clayton County-Wayne County-MI
861,Clayton County-Hillsborough County-FL-1617,"Hillsborough County, FL",1617,2016,2017,83,1326000,66,966000,17,360000,Clayton County,Clayton County-Hillsborough County-FL
862,Clayton County-Mecklenburg County-NC-1617,"Mecklenburg County, NC",1617,2016,2017,93,1424000,92,1324000,1,100000,Clayton County,Clayton County-Mecklenburg County-NC
863,Clayton County-Philadelphia County-PA-1617,"Philadelphia County, PA",1617,2016,2017,114,1307000,58,547000,56,760000,Clayton County,Clayton County-Philadelphia County-PA
864,Clayton County-Shelby County-TN-1617,"Shelby County, TN",1617,2016,2017,109,1172000,38,678000,71,494000,Clayton County,Clayton County-Shelby County-TN
865,Clayton County-Marion County-IN-1617,"Marion County, IN",1617,2016,2017,100,1136000,46,465000,54,671000,Clayton County,Clayton County-Marion County-IN
866,Clayton County-Palm Beach County-FL-1617,"Palm Beach County, FL",1617,2016,2017,99,1323000,63,905000,36,418000,Clayton County,Clayton County-Palm Beach County-FL
867,Clayton County-Carroll County-GA-1617,"Carroll County, GA",1617,2016,2017,70,960000,103,1293000,-33,-333000,Clayton County,Clayton County-Carroll County-GA
868,Clayton County-Paulding County-GA-1617,"Paulding County, GA",1617,2016,2017,91,1291000,128,1944000,-37,-653000,Clayton County,Clayton County-Paulding County-GA
869,Clayton County-Houston County-GA-1617,"Houston County, GA",1617,2016,2017,80,1031000,90,1047000,-10,-16000,Clayton County,Clayton County-Houston County-GA
870,Clayton County-Dallas County-TX-1617,"Dallas County, TX",1617,2016,2017,63,1016000,76,1254000,-13,-238000,Clayton County,Clayton County-Dallas County-TX
871,Clayton County-Richland County-SC-1617,"Richland County, SC",1617,2016,2017,66,660000,46,642000,20,18000,Clayton County,Clayton County-Richland County-SC
872,Clayton County-Mobile County-AL-1617,"Mobile County, AL",1617,2016,2017,60,683000,70,655000,-10,28000,Clayton County,Clayton County-Mobile County-AL
873,Clayton County-Cumberland County-NC-1617,"Cumberland County, NC",1617,2016,2017,57,712000,47,582000,10,130000,Clayton County,Clayton County-Cumberland County-NC
874,Clayton County-Troup County-GA-1617,"Troup County, GA",1617,2016,2017,59,692000,50,854000,9,-162000,Clayton County,Clayton County-Troup County-GA
875,Clayton County-Maricopa County-AZ-1617,"Maricopa County, AZ",1617,2016,2017,55,959000,62,764000,-7,195000,Clayton County,Clayton County-Maricopa County-AZ
876,Clayton County-Butts County-GA-1617,"Butts County, GA",1617,2016,2017,59,964000,124,1467000,-65,-503000,Clayton County,Clayton County-Butts County-GA
877,Clayton County-Cherokee County-GA-1617,"Cherokee County, GA",1617,2016,2017,51,822000,64,1325000,-13,-503000,Clayton County,Clayton County-Cherokee County-GA
878,Clayton County-Clark County-NV-1617,"Clark County, NV",1617,2016,2017,60,796000,81,858000,-21,-62000,Clayton County,Clayton County-Clark County-NV
879,Clayton County-Davidson County-TN-1617,"Davidson County, TN",1617,2016,2017,40,528000,52,1124000,-12,-596000,Clayton County,Clayton County-Davidson County-TN
880,Clayton County-Polk County-FL-1617,"Polk County, FL",1617,2016,2017,49,460000,48,557000,1,-97000,Clayton County,Clayton County-Polk County-FL
881,Clayton County-Tarrant County-TX-1617,"Tarrant County, TX",1617,2016,2017,42,695000,72,1255000,-30,-560000,Clayton County,Clayton County-Tarrant County-TX
882,Clayton County-Clarke County-GA-1617,"Clarke County, GA",1617,2016,2017,34,462000,55,782000,-21,-320000,Clayton County,Clayton County-Clarke County-GA
884,Cobb County-Fulton County-GA-1617,"Fulton County, GA",1617,2016,2017,11525,467876000,11711,491715000,-186,-23839000,Cobb County,Cobb County-Fulton County-GA
885,Cobb County-DeKalb County-GA-1617,"DeKalb County, GA",1617,2016,2017,4700,169134000,3726,137006000,974,32128000,Cobb County,Cobb County-DeKalb County-GA
886,Cobb County-Cherokee County-GA-1617,"Cherokee County, GA",1617,2016,2017,3751,120165000,6649,235644000,-2898,-115479000,Cobb County,Cobb County-Cherokee County-GA
887,Cobb County-Paulding County-GA-1617,"Paulding County, GA",1617,2016,2017,3499,103286000,6865,169751000,-3366,-66465000,Cobb County,Cobb County-Paulding County-GA
888,Cobb County-Gwinnett County-GA-1617,"Gwinnett County, GA",1617,2016,2017,2982,83621000,3112,79112000,-130,4509000,Cobb County,Cobb County-Gwinnett County-GA
889,Cobb County-Douglas County-GA-1617,"Douglas County, GA",1617,2016,2017,2295,48542000,3596,60061000,-1301,-11519000,Cobb County,Cobb County-Douglas County-GA
890,Cobb County-Clayton County-GA-1617,"Clayton County, GA",1617,2016,2017,1054,17839000,1151,17529000,-97,310000,Cobb County,Cobb County-Clayton County-GA
891,Cobb County-Bartow County-GA-1617,"Bartow County, GA",1617,2016,2017,855,19113000,1613,55608000,-758,-36495000,Cobb County,Cobb County-Bartow County-GA
892,Cobb County-Henry County-GA-1617,"Henry County, GA",1617,2016,2017,634,18556000,542,13020000,92,5536000,Cobb County,Cobb County-Henry County-GA
893,Cobb County-Cook County-IL-1617,"Cook County, IL",1617,2016,2017,647,26767000,356,12804000,291,13963000,Cobb County,Cobb County-Cook County-IL
894,Cobb County-Broward County-FL-1617,"Broward County, FL",1617,2016,2017,642,16424000,319,10570000,323,5854000,Cobb County,Cobb County-Broward County-FL
895,Cobb County-Forsyth County-GA-1617,"Forsyth County, GA",1617,2016,2017,526,20655000,1472,58113000,-946,-37458000,Cobb County,Cobb County-Forsyth County-GA
896,Cobb County-Los Angeles County-CA-1617,"Los Angeles County, CA",1617,2016,2017,468,17383000,369,11304000,99,6079000,Cobb County,Cobb County-Los Angeles County-CA
897,Cobb County-Miami-Dade County-FL-1617,"Miami-Dade County, FL",1617,2016,2017,502,14959000,249,7447000,253,7512000,Cobb County,Cobb County-Miami-Dade County-FL
898,Cobb County-Fayette County-GA-1617,"Fayette County, GA",1617,2016,2017,377,16259000,422,15484000,-45,775000,Cobb County,Cobb County-Fayette County-GA
899,Cobb County-Orange County-FL-1617,"Orange County, FL",1617,2016,2017,369,9087000,393,16449000,-24,-7362000,Cobb County,Cobb County-Orange County-FL
900,Cobb County-Harris County-TX-1617,"Harris County, TX",1617,2016,2017,379,13604000,281,8357000,98,5247000,Cobb County,Cobb County-Harris County-TX
901,Cobb County-Carroll County-GA-1617,"Carroll County, GA",1617,2016,2017,352,8688000,451,11259000,-99,-2571000,Cobb County,Cobb County-Carroll County-GA
902,Cobb County-Duval County-FL-1617,"Duval County, FL",1617,2016,2017,327,11251000,285,10207000,42,1044000,Cobb County,Cobb County-Duval County-FL
903,Cobb County-Hillsborough County-FL-1617,"Hillsborough County, FL",1617,2016,2017,354,11496000,467,20437000,-113,-8941000,Cobb County,Cobb County-Hillsborough County-FL
904,Cobb County-Mecklenburg County-NC-1617,"Mecklenburg County, NC",1617,2016,2017,323,12427000,359,20191000,-36,-7764000,Cobb County,Cobb County-Mecklenburg County-NC
905,Cobb County-Chatham County-GA-1617,"Chatham County, GA",1617,2016,2017,276,8816000,279,9577000,-3,-761000,Cobb County,Cobb County-Chatham County-GA
906,Cobb County-Jefferson County-AL-1617,"Jefferson County, AL",1617,2016,2017,330,10572000,219,9631000,111,941000,Cobb County,Cobb County-Jefferson County-AL
907,Cobb County-Palm Beach County-FL-1617,"Palm Beach County, FL",1617,2016,2017,341,11166000,210,9565000,131,1601000,Cobb County,Cobb County-Palm Beach County-FL
908,Cobb County-Coweta County-GA-1617,"Coweta County, GA",1617,2016,2017,287,8965000,358,15602000,-71,-6637000,Cobb County,Cobb County-Coweta County-GA
909,Cobb County-Maricopa County-AZ-1617,"Maricopa County, AZ",1617,2016,2017,312,10206000,281,9639000,31,567000,Cobb County,Cobb County-Maricopa County-AZ
910,Cobb County-Queens County-NY-1617,"Queens County, NY",1617,2016,2017,278,7230000,63,1215000,215,6015000,Cobb County,Cobb County-Queens County-NY
911,Cobb County-Muscogee County-GA-1617,"Muscogee County, GA",1617,2016,2017,260,5582000,157,3884000,103,1698000,Cobb County,Cobb County-Muscogee County-GA
912,Cobb County-Clarke County-GA-1617,"Clarke County, GA",1617,2016,2017,187,4965000,171,6180000,16,-1215000,Cobb County,Cobb County-Clarke County-GA
913,Cobb County-Kings County-NY-1617,"Kings County, NY",1617,2016,2017,227,4263000,142,3667000,85,596000,Cobb County,Cobb County-Kings County-NY
914,Cobb County-Dallas County-TX-1617,"Dallas County, TX",1617,2016,2017,252,9206000,285,11505000,-33,-2299000,Cobb County,Cobb County-Dallas County-TX
915,Cobb County-San Diego County-CA-1617,"San Diego County, CA",1617,2016,2017,244,8395000,174,5812000,70,2583000,Cobb County,Cobb County-San Diego County-CA
916,Cobb County-Rockdale County-GA-1617,"Rockdale County, GA",1617,2016,2017,206,5063000,213,3979000,-7,1084000,Cobb County,Cobb County-Rockdale County-GA
917,Cobb County-Shelby County-TN-1617,"Shelby County, TN",1617,2016,2017,217,7880000,126,4437000,91,3443000,Cobb County,Cobb County-Shelby County-TN
918,Cobb County-Davidson County-TN-1617,"Davidson County, TN",1617,2016,2017,184,6672000,222,7726000,-38,-1054000,Cobb County,Cobb County-Davidson County-TN
919,Cobb County-Wake County-NC-1617,"Wake County, NC",1617,2016,2017,234,7685000,271,10078000,-37,-2393000,Cobb County,Cobb County-Wake County-NC
920,Cobb County-Hall County-GA-1617,"Hall County, GA",1617,2016,2017,175,5553000,267,12792000,-92,-7239000,Cobb County,Cobb County-Hall County-GA
921,Cobb County-Pinellas County-FL-1617,"Pinellas County, FL",1617,2016,2017,199,8786000,198,7828000,1,958000,Cobb County,Cobb County-Pinellas County-FL
922,Cobb County-Bibb County-GA-1617,"Bibb County, GA",1617,2016,2017,183,5132000,138,3543000,45,1589000,Cobb County,Cobb County-Bibb County-GA
923,Cobb County-Travis County-TX-1617,"Travis County, TX",1617,2016,2017,211,6608000,164,10655000,47,-4047000,Cobb County,Cobb County-Travis County-TX
924,Cobb County-Tarrant County-TX-1617,"Tarrant County, TX",1617,2016,2017,192,8689000,253,9525000,-61,-836000,Cobb County,Cobb County-Tarrant County-TX
925,Cobb County-Floyd County-GA-1617,"Floyd County, GA",1617,2016,2017,186,5383000,205,6454000,-19,-1071000,Cobb County,Cobb County-Floyd County-GA
926,Cobb County-Houston County-GA-1617,"Houston County, GA",1617,2016,2017,149,4470000,129,3071000,20,1399000,Cobb County,Cobb County-Houston County-GA
927,Cobb County-Bronx County-NY-1617,"Bronx County, NY",1617,2016,2017,181,3903000,60,919000,121,2984000,Cobb County,Cobb County-Bronx County-NY
928,Cobb County-Hamilton County-TN-1617,"Hamilton County, TN",1617,2016,2017,141,4646000,158,5647000,-17,-1001000,Cobb County,Cobb County-Hamilton County-TN
929,Cobb County-Oakland County-MI-1617,"Oakland County, MI",1617,2016,2017,158,6108000,115,8537000,43,-2429000,Cobb County,Cobb County-Oakland County-MI
930,Cobb County-King County-WA-1617,"King County, WA",1617,2016,2017,165,7924000,249,13309000,-84,-5385000,Cobb County,Cobb County-King County-WA
931,Cobb County-Fairfax County-VA-1617,"Fairfax County, VA",1617,2016,2017,171,9636000,166,7448000,5,2188000,Cobb County,Cobb County-Fairfax County-VA
932,Cobb County-Richmond County-GA-1617,"Richmond County, GA",1617,2016,2017,144,2967000,139,3237000,5,-270000,Cobb County,Cobb County-Richmond County-GA
933,Cobb County-Newton County-GA-1617,"Newton County, GA",1617,2016,2017,158,3776000,133,3299000,25,477000,Cobb County,Cobb County-Newton County-GA
934,Cobb County-Richland County-SC-1617,"Richland County, SC",1617,2016,2017,151,3915000,94,2595000,57,1320000,Cobb County,Cobb County-Richland County-SC
935,Cobb County-Leon County-FL-1617,"Leon County, FL",1617,2016,2017,134,4594000,86,3639000,48,955000,Cobb County,Cobb County-Leon County-FL
936,Cobb County-Cuyahoga County-OH-1617,"Cuyahoga County, OH",1617,2016,2017,151,3236000,99,2530000,52,706000,Cobb County,Cobb County-Cuyahoga County-OH
937,Cobb County-Franklin County-OH-1617,"Franklin County, OH",1617,2016,2017,143,4794000,110,4032000,33,762000,Cobb County,Cobb County-Franklin County-OH
938,Cobb County-Knox County-TN-1617,"Knox County, TN",1617,2016,2017,135,5694000,118,4918000,17,776000,Cobb County,Cobb County-Knox County-TN
939,Cobb County-Orange County-CA-1617,"Orange County, CA",1617,2016,2017,160,6075000,123,6750000,37,-675000,Cobb County,Cobb County-Orange County-CA
940,Cobb County-Greenville County-SC-1617,"Greenville County, SC",1617,2016,2017,151,5878000,169,6371000,-18,-493000,Cobb County,Cobb County-Greenville County-SC
941,Cobb County-New York County-NY-1617,"New York County, NY",1617,2016,2017,112,4967000,87,4783000,25,184000,Cobb County,Cobb County-New York County-NY
942,Cobb County-Prince George's County-MD-1617,"Prince George's County, MD",1617,2016,2017,134,4477000,106,2155000,28,2322000,Cobb County,Cobb County-Prince George's County-MD
943,Cobb County-Hennepin County-MN-1617,"Hennepin County, MN",1617,2016,2017,146,7412000,90,5162000,56,2250000,Cobb County,Cobb County-Hennepin County-MN
944,Cobb County-St. Louis County-MO-1617,"St. Louis County, MO",1617,2016,2017,152,4819000,68,2720000,84,2099000,Cobb County,Cobb County-St. Louis County-MO
945,Cobb County-Allegheny County-PA-1617,"Allegheny County, PA",1617,2016,2017,121,4489000,60,2454000,61,2035000,Cobb County,Cobb County-Allegheny County-PA
946,Cobb County-Dougherty County-GA-1617,"Dougherty County, GA",1617,2016,2017,141,2191000,55,777000,86,1414000,Cobb County,Cobb County-Dougherty County-GA
947,Cobb County-Middlesex County-MA-1617,"Middlesex County, MA",1617,2016,2017,125,4753000,79,3717000,46,1036000,Cobb County,Cobb County-Middlesex County-MA
948,Cobb County-Wayne County-MI-1617,"Wayne County, MI",1617,2016,2017,129,2961000,102,2561000,27,400000,Cobb County,Cobb County-Wayne County-MI
949,Cobb County-Nassau County-NY-1617,"Nassau County, NY",1617,2016,2017,136,5267000,45,1064000,91,4203000,Cobb County,Cobb County-Nassau County-NY
950,Cobb County-Montgomery County-AL-1617,"Montgomery County, AL",1617,2016,2017,128,3919000,44,744000,84,3175000,Cobb County,Cobb County-Montgomery County-AL
951,Cobb County-Columbia County-GA-1617,"Columbia County, GA",1617,2016,2017,115,4670000,147,4811000,-32,-141000,Cobb County,Cobb County-Columbia County-GA
952,Cobb County-Lowndes County-GA-1617,"Lowndes County, GA",1617,2016,2017,113,3013000,75,2163000,38,850000,Cobb County,Cobb County-Lowndes County-GA
953,Cobb County-Fairfield County-CT-1617,"Fairfield County, CT",1617,2016,2017,160,8565000,41,2280000,119,6285000,Cobb County,Cobb County-Fairfield County-CT
954,Cobb County-Clark County-NV-1617,"Clark County, NV",1617,2016,2017,114,2978000,183,6303000,-69,-3325000,Cobb County,Cobb County-Clark County-NV
955,Cobb County-Guilford County-NC-1617,"Guilford County, NC",1617,2016,2017,121,3671000,77,2570000,44,1101000,Cobb County,Cobb County-Guilford County-NC
956,Cobb County-Charleston County-SC-1617,"Charleston County, SC",1617,2016,2017,111,3389000,158,9007000,-47,-5618000,Cobb County,Cobb County-Charleston County-SC
957,Cobb County-Lee County-FL-1617,"Lee County, FL",1617,2016,2017,113,3795000,102,4702000,11,-907000,Cobb County,Cobb County-Lee County-FL
958,Cobb County-Montgomery County-MD-1617,"Montgomery County, MD",1617,2016,2017,134,5528000,118,4309000,16,1219000,Cobb County,Cobb County-Montgomery County-MD
959,Cobb County-Suffolk County-NY-1617,"Suffolk County, NY",1617,2016,2017,123,3812000,52,2228000,71,1584000,Cobb County,Cobb County-Suffolk County-NY
960,Cobb County-Hamilton County-OH-1617,"Hamilton County, OH",1617,2016,2017,107,4373000,60,1950000,47,2423000,Cobb County,Cobb County-Hamilton County-OH
961,Cobb County-Lee County-AL-1617,"Lee County, AL",1617,2016,2017,97,2618000,80,4368000,17,-1750000,Cobb County,Cobb County-Lee County-AL
962,Cobb County-Santa Clara County-CA-1617,"Santa Clara County, CA",1617,2016,2017,128,7855000,139,6667000,-11,1188000,Cobb County,Cobb County-Santa Clara County-CA
963,Cobb County-Bulloch County-GA-1617,"Bulloch County, GA",1617,2016,2017,94,1704000,41,1607000,53,97000,Cobb County,Cobb County-Bulloch County-GA
964,Cobb County-DuPage County-IL-1617,"DuPage County, IL",1617,2016,2017,139,7172000,66,2803000,73,4369000,Cobb County,Cobb County-DuPage County-IL
965,Cobb County-Philadelphia County-PA-1617,"Philadelphia County, PA",1617,2016,2017,104,3582000,83,5222000,21,-1640000,Cobb County,Cobb County-Philadelphia County-PA
966,Cobb County-Bexar County-TX-1617,"Bexar County, TX",1617,2016,2017,126,3939000,109,3071000,17,868000,Cobb County,Cobb County-Bexar County-TX
967,Cobb County-Seminole County-FL-1617,"Seminole County, FL",1617,2016,2017,105,3201000,82,2365000,23,836000,Cobb County,Cobb County-Seminole County-FL
968,Cobb County-Gordon County-GA-1617,"Gordon County, GA",1617,2016,2017,112,2308000,110,3932000,2,-1624000,Cobb County,Cobb County-Gordon County-GA
969,Cobb County-Madison County-AL-1617,"Madison County, AL",1617,2016,2017,90,2990000,86,3824000,4,-834000,Cobb County,Cobb County-Madison County-AL
970,Cobb County-Honolulu County-HI-1617,"Honolulu County, HI",1617,2016,2017,115,2991000,39,1631000,76,1360000,Cobb County,Cobb County-Honolulu County-HI
971,Cobb County-Marion County-IN-1617,"Marion County, IN",1617,2016,2017,112,2546000,91,1488000,21,1058000,Cobb County,Cobb County-Marion County-IN
972,Cobb County-Alachua County-FL-1617,"Alachua County, FL",1617,2016,2017,89,3429000,52,1387000,37,2042000,Cobb County,Cobb County-Alachua County-FL
973,Cobb County-Middlesex County-NJ-1617,"Middlesex County, NJ",1617,2016,2017,124,4258000,77,2875000,47,1383000,Cobb County,Cobb County-Middlesex County-NJ
974,Cobb County-Walton County-GA-1617,"Walton County, GA",1617,2016,2017,95,2756000,107,3431000,-12,-675000,Cobb County,Cobb County-Walton County-GA
975,Cobb County-Milwaukee County-WI-1617,"Milwaukee County, WI",1617,2016,2017,98,2456000,52,1449000,46,1007000,Cobb County,Cobb County-Milwaukee County-WI
976,Cobb County-Jefferson County-KY-1617,"Jefferson County, KY",1617,2016,2017,97,3661000,108,5022000,-11,-1361000,Cobb County,Cobb County-Jefferson County-KY
977,Cobb County-Essex County-NJ-1617,"Essex County, NJ",1617,2016,2017,112,2787000,34,1941000,78,846000,Cobb County,Cobb County-Essex County-NJ
978,Cobb County-Alameda County-CA-1617,"Alameda County, CA",1617,2016,2017,85,4388000,98,4082000,-13,306000,Cobb County,Cobb County-Alameda County-CA
979,Cobb County-Whitfield County-GA-1617,"Whitfield County, GA",1617,2016,2017,85,2504000,62,2183000,23,321000,Cobb County,Cobb County-Whitfield County-GA
980,Cobb County-Collin County-TX-1617,"Collin County, TX",1617,2016,2017,104,4538000,175,7867000,-71,-3329000,Cobb County,Cobb County-Collin County-TX
981,Cobb County-District of Columbia-DC-1617,"District of Columbia, DC",1617,2016,2017,77,3731000,63,2823000,14,908000,Cobb County,Cobb County-District of Columbia-DC
982,Cobb County-East Baton Rouge Parish-LA-1617,"East Baton Rouge Parish, LA",1617,2016,2017,96,2495000,53,1295000,43,1200000,Cobb County,Cobb County-East Baton Rouge Parish-LA
983,Cobb County-Shelby County-AL-1617,"Shelby County, AL",1617,2016,2017,105,3373000,115,4372000,-10,-999000,Cobb County,Cobb County-Shelby County-AL
984,Cobb County-Jefferson Parish-LA-1617,"Jefferson Parish, LA",1617,2016,2017,85,1993000,63,1284000,22,709000,Cobb County,Cobb County-Jefferson Parish-LA
985,Cobb County-Contra Costa County-CA-1617,"Contra Costa County, CA",1617,2016,2017,99,5640000,56,2205000,43,3435000,Cobb County,Cobb County-Contra Costa County-CA
986,Cobb County-Brevard County-FL-1617,"Brevard County, FL",1617,2016,2017,75,2220000,168,6143000,-93,-3923000,Cobb County,Cobb County-Brevard County-FL
987,Cobb County-Erie County-NY-1617,"Erie County, NY",1617,2016,2017,92,1826000,48,1030000,44,796000,Cobb County,Cobb County-Erie County-NY
988,Cobb County-Rutherford County-TN-1617,"Rutherford County, TN",1617,2016,2017,82,2272000,51,1904000,31,368000,Cobb County,Cobb County-Rutherford County-TN
989,Cobb County-Mobile County-AL-1617,"Mobile County, AL",1617,2016,2017,90,1931000,71,1941000,19,-10000,Cobb County,Cobb County-Mobile County-AL
990,Cobb County-Polk County-GA-1617,"Polk County, GA",1617,2016,2017,111,1953000,140,3044000,-29,-1091000,Cobb County,Cobb County-Polk County-GA
991,Cobb County-Cumberland County-NC-1617,"Cumberland County, NC",1617,2016,2017,83,1810000,52,1034000,31,776000,Cobb County,Cobb County-Cumberland County-NC
992,Cobb County-Volusia County-FL-1617,"Volusia County, FL",1617,2016,2017,87,2448000,118,4974000,-31,-2526000,Cobb County,Cobb County-Volusia County-FL
993,Cobb County-Baltimore County-MD-1617,"Baltimore County, MD",1617,2016,2017,88,3263000,60,1583000,28,1680000,Cobb County,Cobb County-Baltimore County-MD
994,Cobb County-Virginia Beach city-VA-1617,"Virginia Beach city, VA",1617,2016,2017,83,2612000,53,1134000,30,1478000,Cobb County,Cobb County-Virginia Beach city-VA
995,Cobb County-Escambia County-FL-1617,"Escambia County, FL",1617,2016,2017,79,2928000,109,3457000,-30,-529000,Cobb County,Cobb County-Escambia County-FL
996,Cobb County-Pickens County-GA-1617,"Pickens County, GA",1617,2016,2017,71,2610000,273,11260000,-202,-8650000,Cobb County,Cobb County-Pickens County-GA
997,Cobb County-Denver County-CO-1617,"Denver County, CO",1617,2016,2017,66,2569000,98,6562000,-32,-3993000,Cobb County,Cobb County-Denver County-CO
998,Cobb County-Tuscaloosa County-AL-1617,"Tuscaloosa County, AL",1617,2016,2017,65,1766000,52,1911000,13,-145000,Cobb County,Cobb County-Tuscaloosa County-AL
999,Cobb County-Arapahoe County-CO-1617,"Arapahoe County, CO",1617,2016,2017,73,2488000,78,3256000,-5,-768000,Cobb County,Cobb County-Arapahoe County-CO
1000,Cobb County-Polk County-FL-1617,"Polk County, FL",1617,2016,2017,74,2101000,92,2244000,-18,-143000,Cobb County,Cobb County-Polk County-FL
1001,Cobb County-New Haven County-CT-1617,"New Haven County, CT",1617,2016,2017,61,1867000,36,1052000,25,815000,Cobb County,Cobb County-New Haven County-CT
1002,Cobb County-Suffolk County-MA-1617,"Suffolk County, MA",1617,2016,2017,54,2385000,39,2421000,15,-36000,Cobb County,Cobb County-Suffolk County-MA
1003,Cobb County-Sacramento County-CA-1617,"Sacramento County, CA",1617,2016,2017,74,2420000,59,1509000,15,911000,Cobb County,Cobb County-Sacramento County-CA
1004,Cobb County-Johnson County-KS-1617,"Johnson County, KS",1617,2016,2017,80,2818000,41,1616000,39,1202000,Cobb County,Cobb County-Johnson County-KS
1005,Cobb County-Durham County-NC-1617,"Durham County, NC",1617,2016,2017,67,2316000,55,2309000,12,7000,Cobb County,Cobb County-Durham County-NC
1006,Cobb County-Okaloosa County-FL-1617,"Okaloosa County, FL",1617,2016,2017,77,1974000,71,3147000,6,-1173000,Cobb County,Cobb County-Okaloosa County-FL
1007,Cobb County-St. Lucie County-FL-1617,"St. Lucie County, FL",1617,2016,2017,64,1373000,55,1272000,9,101000,Cobb County,Cobb County-St. Lucie County-FL
1008,Cobb County-Glynn County-GA-1617,"Glynn County, GA",1617,2016,2017,55,1096000,111,6901000,-56,-5805000,Cobb County,Cobb County-Glynn County-GA
1009,Cobb County-Orleans Parish-LA-1617,"Orleans Parish, LA",1617,2016,2017,63,1282000,102,2082000,-39,-800000,Cobb County,Cobb County-Orleans Parish-LA
1010,Cobb County-Williamson County-TN-1617,"Williamson County, TN",1617,2016,2017,75,4152000,138,7188000,-63,-3036000,Cobb County,Cobb County-Williamson County-TN
1011,Cobb County-Barrow County-GA-1617,"Barrow County, GA",1617,2016,2017,66,1387000,76,2018000,-10,-631000,Cobb County,Cobb County-Barrow County-GA
1012,Cobb County-Riverside County-CA-1617,"Riverside County, CA",1617,2016,2017,80,1540000,72,2813000,8,-1273000,Cobb County,Cobb County-Riverside County-CA
1013,Cobb County-New Castle County-DE-1617,"New Castle County, DE",1617,2016,2017,62,1271000,53,2127000,9,-856000,Cobb County,Cobb County-New Castle County-DE
1014,Cobb County-Bay County-FL-1617,"Bay County, FL",1617,2016,2017,61,1472000,109,5247000,-48,-3775000,Cobb County,Cobb County-Bay County-FL
1015,Cobb County-Spalding County-GA-1617,"Spalding County, GA",1617,2016,2017,62,1394000,87,2690000,-25,-1296000,Cobb County,Cobb County-Spalding County-GA
1016,Cobb County-Prince William County-VA-1617,"Prince William County, VA",1617,2016,2017,72,2882000,59,1461000,13,1421000,Cobb County,Cobb County-Prince William County-VA
1017,Cobb County-Hartford County-CT-1617,"Hartford County, CT",1617,2016,2017,57,2385000,67,2716000,-10,-331000,Cobb County,Cobb County-Hartford County-CT
1018,Cobb County-Montgomery County-PA-1617,"Montgomery County, PA",1617,2016,2017,63,3336000,48,2384000,15,952000,Cobb County,Cobb County-Montgomery County-PA
1019,Cobb County-Sarasota County-FL-1617,"Sarasota County, FL",1617,2016,2017,54,2124000,88,4953000,-34,-2829000,Cobb County,Cobb County-Sarasota County-FL
1020,Cobb County-Denton County-TX-1617,"Denton County, TX",1617,2016,2017,69,3292000,132,6779000,-63,-3487000,Cobb County,Cobb County-Denton County-TX
1021,Cobb County-Fort Bend County-TX-1617,"Fort Bend County, TX",1617,2016,2017,110,6463000,92,4427000,18,2036000,Cobb County,Cobb County-Fort Bend County-TX
1022,Cobb County-Loudoun County-VA-1617,"Loudoun County, VA",1617,2016,2017,74,3706000,60,3098000,14,608000,Cobb County,Cobb County-Loudoun County-VA
1023,Cobb County-El Paso County-CO-1617,"El Paso County, CO",1617,2016,2017,66,1233000,80,2879000,-14,-1646000,Cobb County,Cobb County-El Paso County-CO
1024,Cobb County-Anne Arundel County-MD-1617,"Anne Arundel County, MD",1617,2016,2017,63,1204000,50,1480000,13,-276000,Cobb County,Cobb County-Anne Arundel County-MD
1025,Cobb County-Montgomery County-OH-1617,"Montgomery County, OH",1617,2016,2017,45,1631000,50,1078000,-5,553000,Cobb County,Cobb County-Montgomery County-OH
1026,Cobb County-Henrico County-VA-1617,"Henrico County, VA",1617,2016,2017,73,3713000,55,1551000,18,2162000,Cobb County,Cobb County-Henrico County-VA
1027,Cobb County-Osceola County-FL-1617,"Osceola County, FL",1617,2016,2017,50,810000,56,1364000,-6,-554000,Cobb County,Cobb County-Osceola County-FL
1028,Cobb County-Kent County-MI-1617,"Kent County, MI",1617,2016,2017,70,1400000,43,1347000,27,53000,Cobb County,Cobb County-Kent County-MI
1029,Cobb County-Lexington County-SC-1617,"Lexington County, SC",1617,2016,2017,53,1534000,53,2193000,0,-659000,Cobb County,Cobb County-Lexington County-SC
1030,Cobb County-Marion County-FL-1617,"Marion County, FL",1617,2016,2017,42,1001000,59,1284000,-17,-283000,Cobb County,Cobb County-Marion County-FL
1031,Cobb County-Hudson County-NJ-1617,"Hudson County, NJ",1617,2016,2017,58,2942000,53,2144000,5,798000,Cobb County,Cobb County-Hudson County-NJ
1032,Cobb County-Forsyth County-NC-1617,"Forsyth County, NC",1617,2016,2017,53,2854000,54,1962000,-1,892000,Cobb County,Cobb County-Forsyth County-NC
1033,Cobb County-Arlington County-VA-1617,"Arlington County, VA",1617,2016,2017,39,2675000,33,1839000,6,836000,Cobb County,Cobb County-Arlington County-VA
1034,Cobb County-Norfolk city-VA-1617,"Norfolk city, VA",1617,2016,2017,66,1208000,38,512000,28,696000,Cobb County,Cobb County-Norfolk city-VA
1035,Cobb County-Lake County-FL-1617,"Lake County, FL",1617,2016,2017,49,1193000,77,2708000,-28,-1515000,Cobb County,Cobb County-Lake County-FL
1036,Cobb County-Beaufort County-SC-1617,"Beaufort County, SC",1617,2016,2017,53,1868000,155,10554000,-102,-8686000,Cobb County,Cobb County-Beaufort County-SC
1037,Cobb County-Bell County-TX-1617,"Bell County, TX",1617,2016,2017,60,1537000,44,999000,16,538000,Cobb County,Cobb County-Bell County-TX
1038,Cobb County-Alexandria city-VA-1617,"Alexandria city, VA",1617,2016,2017,46,2626000,35,2023000,11,603000,Cobb County,Cobb County-Alexandria city-VA
1039,Cobb County-Troup County-GA-1617,"Troup County, GA",1617,2016,2017,49,1114000,73,1485000,-24,-371000,Cobb County,Cobb County-Troup County-GA
1040,Cobb County-Norfolk County-MA-1617,"Norfolk County, MA",1617,2016,2017,44,2056000,48,1883000,-4,173000,Cobb County,Cobb County-Norfolk County-MA
1041,Cobb County-Pasco County-FL-1617,"Pasco County, FL",1617,2016,2017,52,1783000,137,5764000,-85,-3981000,Cobb County,Cobb County-Pasco County-FL
1042,Cobb County-Horry County-SC-1617,"Horry County, SC",1617,2016,2017,64,1343000,49,2343000,15,-1000000,Cobb County,Cobb County-Horry County-SC
1043,Cobb County-Chesterfield County-VA-1617,"Chesterfield County, VA",1617,2016,2017,56,1935000,46,2069000,10,-134000,Cobb County,Cobb County-Chesterfield County-VA
1044,Cobb County-Pierce County-WA-1617,"Pierce County, WA",1617,2016,2017,50,1417000,67,1389000,-17,28000,Cobb County,Cobb County-Pierce County-WA
1045,Cobb County-Manatee County-FL-1617,"Manatee County, FL",1617,2016,2017,61,1618000,124,7485000,-63,-5867000,Cobb County,Cobb County-Manatee County-FL
1046,Cobb County-Berkeley County-SC-1617,"Berkeley County, SC",1617,2016,2017,37,1236000,46,1727000,-9,-491000,Cobb County,Cobb County-Berkeley County-SC
1047,Cobb County-York County-SC-1617,"York County, SC",1617,2016,2017,44,2236000,74,3790000,-30,-1554000,Cobb County,Cobb County-York County-SC
1048,Cobb County-Buncombe County-NC-1617,"Buncombe County, NC",1617,2016,2017,35,1226000,75,3373000,-40,-2147000,Cobb County,Cobb County-Buncombe County-NC
1049,Cobb County-Montgomery County-TX-1617,"Montgomery County, TX",1617,2016,2017,54,2403000,61,2825000,-7,-422000,Cobb County,Cobb County-Montgomery County-TX
1050,Cobb County-Williamson County-TX-1617,"Williamson County, TX",1617,2016,2017,43,2132000,92,3008000,-49,-876000,Cobb County,Cobb County-Williamson County-TX
1051,Cobb County-Liberty County-GA-1617,"Liberty County, GA",1617,2016,2017,41,1245000,34,445000,7,800000,Cobb County,Cobb County-Liberty County-GA
1052,Cobb County-Aiken County-SC-1617,"Aiken County, SC",1617,2016,2017,38,1383000,40,1192000,-2,191000,Cobb County,Cobb County-Aiken County-SC
1053,Cobb County-Spartanburg County-SC-1617,"Spartanburg County, SC",1617,2016,2017,43,1598000,43,1682000,0,-84000,Cobb County,Cobb County-Spartanburg County-SC
1054,Cobb County-Baldwin County-AL-1617,"Baldwin County, AL",1617,2016,2017,39,1223000,95,4703000,-56,-3480000,Cobb County,Cobb County-Baldwin County-AL
1055,Cobb County-St. Johns County-FL-1617,"St. Johns County, FL",1617,2016,2017,65,2335000,139,8343000,-74,-6008000,Cobb County,Cobb County-St. Johns County-FL
1056,Cobb County-Catoosa County-GA-1617,"Catoosa County, GA",1617,2016,2017,38,875000,33,1052000,5,-177000,Cobb County,Cobb County-Catoosa County-GA
1057,Cobb County-Dawson County-GA-1617,"Dawson County, GA",1617,2016,2017,38,1040000,42,2051000,-4,-1011000,Cobb County,Cobb County-Dawson County-GA
1058,Cobb County-Salt Lake County-UT-1617,"Salt Lake County, UT",1617,2016,2017,54,1972000,64,1694000,-10,278000,Cobb County,Cobb County-Salt Lake County-UT
1059,Cobb County-St. Tammany Parish-LA-1617,"St. Tammany Parish, LA",1617,2016,2017,39,1242000,48,1982000,-9,-740000,Cobb County,Cobb County-St. Tammany Parish-LA
1060,Cobb County-Jackson County-MO-1617,"Jackson County, MO",1617,2016,2017,40,1284000,49,1036000,-9,248000,Cobb County,Cobb County-Jackson County-MO
1062,DeKalb County-Fulton County-GA-1617,"Fulton County, GA",1617,2016,2017,17822,907964000,17757,956592000,65,-48628000,DeKalb County,DeKalb County-Fulton County-GA
1063,DeKalb County-Gwinnett County-GA-1617,"Gwinnett County, GA",1617,2016,2017,10247,244502000,15456,322417000,-5209,-77915000,DeKalb County,DeKalb County-Gwinnett County-GA
1064,DeKalb County-Cobb County-GA-1617,"Cobb County, GA",1617,2016,2017,3726,137006000,4700,169134000,-974,-32128000,DeKalb County,DeKalb County-Cobb County-GA
1065,DeKalb County-Clayton County-GA-1617,"Clayton County, GA",1617,2016,2017,2957,39627000,4102,50678000,-1145,-11051000,DeKalb County,DeKalb County-Clayton County-GA
1066,DeKalb County-Rockdale County-GA-1617,"Rockdale County, GA",1617,2016,2017,1412,23940000,2372,38993000,-960,-15053000,DeKalb County,DeKalb County-Rockdale County-GA
1067,DeKalb County-Henry County-GA-1617,"Henry County, GA",1617,2016,2017,1249,26660000,2155,46444000,-906,-19784000,DeKalb County,DeKalb County-Henry County-GA
1068,DeKalb County-Newton County-GA-1617,"Newton County, GA",1617,2016,2017,834,13406000,1400,23272000,-566,-9866000,DeKalb County,DeKalb County-Newton County-GA
1069,DeKalb County-Cook County-IL-1617,"Cook County, IL",1617,2016,2017,645,23018000,406,16439000,239,6579000,DeKalb County,DeKalb County-Cook County-IL
1070,DeKalb County-Los Angeles County-CA-1617,"Los Angeles County, CA",1617,2016,2017,524,22674000,413,16777000,111,5897000,DeKalb County,DeKalb County-Los Angeles County-CA
1071,DeKalb County-Douglas County-GA-1617,"Douglas County, GA",1617,2016,2017,543,11875000,621,11599000,-78,276000,DeKalb County,DeKalb County-Douglas County-GA
1072,DeKalb County-Kings County-NY-1617,"Kings County, NY",1617,2016,2017,500,13352000,250,7366000,250,5986000,DeKalb County,DeKalb County-Kings County-NY
1073,DeKalb County-Miami-Dade County-FL-1617,"Miami-Dade County, FL",1617,2016,2017,488,9744000,240,6747000,248,2997000,DeKalb County,DeKalb County-Miami-Dade County-FL
1074,DeKalb County-Broward County-FL-1617,"Broward County, FL",1617,2016,2017,455,11509000,281,15320000,174,-3811000,DeKalb County,DeKalb County-Broward County-FL
1075,DeKalb County-Forsyth County-GA-1617,"Forsyth County, GA",1617,2016,2017,380,18958000,1368,56123000,-988,-37165000,DeKalb County,DeKalb County-Forsyth County-GA
1076,DeKalb County-Mecklenburg County-NC-1617,"Mecklenburg County, NC",1617,2016,2017,405,16470000,394,16781000,11,-311000,DeKalb County,DeKalb County-Mecklenburg County-NC
1077,DeKalb County-Clarke County-GA-1617,"Clarke County, GA",1617,2016,2017,318,8220000,278,7425000,40,795000,DeKalb County,DeKalb County-Clarke County-GA
1078,DeKalb County-Orange County-FL-1617,"Orange County, FL",1617,2016,2017,375,10718000,306,9927000,69,791000,DeKalb County,DeKalb County-Orange County-FL
1079,DeKalb County-Harris County-TX-1617,"Harris County, TX",1617,2016,2017,409,15161000,337,16365000,72,-1204000,DeKalb County,DeKalb County-Harris County-TX
1080,DeKalb County-Chatham County-GA-1617,"Chatham County, GA",1617,2016,2017,354,7236000,247,7234000,107,2000,DeKalb County,DeKalb County-Chatham County-GA
1081,DeKalb County-Cherokee County-GA-1617,"Cherokee County, GA",1617,2016,2017,291,9930000,547,20140000,-256,-10210000,DeKalb County,DeKalb County-Cherokee County-GA
1082,DeKalb County-Duval County-FL-1617,"Duval County, FL",1617,2016,2017,283,8361000,327,9099000,-44,-738000,DeKalb County,DeKalb County-Duval County-FL
1083,DeKalb County-Hillsborough County-FL-1617,"Hillsborough County, FL",1617,2016,2017,311,9376000,289,11062000,22,-1686000,DeKalb County,DeKalb County-Hillsborough County-FL
1084,DeKalb County-Travis County-TX-1617,"Travis County, TX",1617,2016,2017,332,9450000,176,5560000,156,3890000,DeKalb County,DeKalb County-Travis County-TX
1085,DeKalb County-Jefferson County-AL-1617,"Jefferson County, AL",1617,2016,2017,280,9340000,225,6748000,55,2592000,DeKalb County,DeKalb County-Jefferson County-AL
1086,DeKalb County-Queens County-NY-1617,"Queens County, NY",1617,2016,2017,277,7988000,124,3380000,153,4608000,DeKalb County,DeKalb County-Queens County-NY
1087,DeKalb County-Fayette County-GA-1617,"Fayette County, GA",1617,2016,2017,275,11858000,321,11687000,-46,171000,DeKalb County,DeKalb County-Fayette County-GA
1088,DeKalb County-Davidson County-TN-1617,"Davidson County, TN",1617,2016,2017,276,9597000,248,10834000,28,-1237000,DeKalb County,DeKalb County-Davidson County-TN
1089,DeKalb County-New York County-NY-1617,"New York County, NY",1617,2016,2017,222,12150000,243,14030000,-21,-1880000,DeKalb County,DeKalb County-New York County-NY
1090,DeKalb County-District of Columbia-DC-1617,"District of Columbia, DC",1617,2016,2017,220,10602000,149,7330000,71,3272000,DeKalb County,DeKalb County-District of Columbia-DC
1091,DeKalb County-Hall County-GA-1617,"Hall County, GA",1617,2016,2017,248,7062000,349,11650000,-101,-4588000,DeKalb County,DeKalb County-Hall County-GA
1092,DeKalb County-Dallas County-TX-1617,"Dallas County, TX",1617,2016,2017,285,9437000,301,13102000,-16,-3665000,DeKalb County,DeKalb County-Dallas County-TX
1093,DeKalb County-Muscogee County-GA-1617,"Muscogee County, GA",1617,2016,2017,254,5722000,199,4574000,55,1148000,DeKalb County,DeKalb County-Muscogee County-GA
1094,DeKalb County-Shelby County-TN-1617,"Shelby County, TN",1617,2016,2017,259,7508000,171,4001000,88,3507000,DeKalb County,DeKalb County-Shelby County-TN
1095,DeKalb County-Richmond County-GA-1617,"Richmond County, GA",1617,2016,2017,260,4954000,170,3200000,90,1754000,DeKalb County,DeKalb County-Richmond County-GA
1096,DeKalb County-Palm Beach County-FL-1617,"Palm Beach County, FL",1617,2016,2017,268,7382000,197,13746000,71,-6364000,DeKalb County,DeKalb County-Palm Beach County-FL
1097,DeKalb County-Bibb County-GA-1617,"Bibb County, GA",1617,2016,2017,240,5439000,165,3027000,75,2412000,DeKalb County,DeKalb County-Bibb County-GA
1098,DeKalb County-Philadelphia County-PA-1617,"Philadelphia County, PA",1617,2016,2017,238,8071000,113,4044000,125,4027000,DeKalb County,DeKalb County-Philadelphia County-PA
1099,DeKalb County-Walton County-GA-1617,"Walton County, GA",1617,2016,2017,250,5875000,347,9064000,-97,-3189000,DeKalb County,DeKalb County-Walton County-GA
1100,DeKalb County-Maricopa County-AZ-1617,"Maricopa County, AZ",1617,2016,2017,229,8440000,251,7550000,-22,890000,DeKalb County,DeKalb County-Maricopa County-AZ
1101,DeKalb County-Wake County-NC-1617,"Wake County, NC",1617,2016,2017,219,7794000,202,8237000,17,-443000,DeKalb County,DeKalb County-Wake County-NC
1102,DeKalb County-Bronx County-NY-1617,"Bronx County, NY",1617,2016,2017,234,3655000,77,1239000,157,2416000,DeKalb County,DeKalb County-Bronx County-NY
1103,DeKalb County-Franklin County-OH-1617,"Franklin County, OH",1617,2016,2017,204,7484000,345,6483000,-141,1001000,DeKalb County,DeKalb County-Franklin County-OH
1104,DeKalb County-Montgomery County-MD-1617,"Montgomery County, MD",1617,2016,2017,219,9490000,151,7696000,68,1794000,DeKalb County,DeKalb County-Montgomery County-MD
1105,DeKalb County-King County-WA-1617,"King County, WA",1617,2016,2017,207,10834000,271,15023000,-64,-4189000,DeKalb County,DeKalb County-King County-WA
1106,DeKalb County-Coweta County-GA-1617,"Coweta County, GA",1617,2016,2017,190,6269000,252,9346000,-62,-3077000,DeKalb County,DeKalb County-Coweta County-GA
1107,DeKalb County-Richland County-SC-1617,"Richland County, SC",1617,2016,2017,179,6575000,143,3781000,36,2794000,DeKalb County,DeKalb County-Richland County-SC
1108,DeKalb County-Prince George's County-MD-1617,"Prince George's County, MD",1617,2016,2017,171,4129000,134,3068000,37,1061000,DeKalb County,DeKalb County-Prince George's County-MD
1109,DeKalb County-Paulding County-GA-1617,"Paulding County, GA",1617,2016,2017,178,4520000,317,6267000,-139,-1747000,DeKalb County,DeKalb County-Paulding County-GA
1110,DeKalb County-Leon County-FL-1617,"Leon County, FL",1617,2016,2017,151,3544000,50,1281000,101,2263000,DeKalb County,DeKalb County-Leon County-FL
1111,DeKalb County-Alameda County-CA-1617,"Alameda County, CA",1617,2016,2017,149,7297000,167,7761000,-18,-464000,DeKalb County,DeKalb County-Alameda County-CA
1112,DeKalb County-Wayne County-MI-1617,"Wayne County, MI",1617,2016,2017,178,4457000,135,1374000,43,3083000,DeKalb County,DeKalb County-Wayne County-MI
1113,DeKalb County-Fairfax County-VA-1617,"Fairfax County, VA",1617,2016,2017,171,7363000,144,7135000,27,228000,DeKalb County,DeKalb County-Fairfax County-VA
1114,DeKalb County-Dougherty County-GA-1617,"Dougherty County, GA",1617,2016,2017,165,2311000,82,1558000,83,753000,DeKalb County,DeKalb County-Dougherty County-GA
1115,DeKalb County-Middlesex County-MA-1617,"Middlesex County, MA",1617,2016,2017,150,7045000,126,7063000,24,-18000,DeKalb County,DeKalb County-Middlesex County-MA
1116,DeKalb County-Orleans Parish-LA-1617,"Orleans Parish, LA",1617,2016,2017,139,3551000,106,3092000,33,459000,DeKalb County,DeKalb County-Orleans Parish-LA
1117,DeKalb County-Charleston County-SC-1617,"Charleston County, SC",1617,2016,2017,152,4841000,148,5789000,4,-948000,DeKalb County,DeKalb County-Charleston County-SC
1118,DeKalb County-Durham County-NC-1617,"Durham County, NC",1617,2016,2017,147,5949000,99,4286000,48,1663000,DeKalb County,DeKalb County-Durham County-NC
1119,DeKalb County-San Diego County-CA-1617,"San Diego County, CA",1617,2016,2017,160,5608000,181,7709000,-21,-2101000,DeKalb County,DeKalb County-San Diego County-CA
1120,DeKalb County-Suffolk County-MA-1617,"Suffolk County, MA",1617,2016,2017,128,5756000,91,2422000,37,3334000,DeKalb County,DeKalb County-Suffolk County-MA
1121,DeKalb County-Alachua County-FL-1617,"Alachua County, FL",1617,2016,2017,111,3554000,43,1094000,68,2460000,DeKalb County,DeKalb County-Alachua County-FL
1122,DeKalb County-Oakland County-MI-1617,"Oakland County, MI",1617,2016,2017,160,5508000,56,2529000,104,2979000,DeKalb County,DeKalb County-Oakland County-MI
1123,DeKalb County-Pinellas County-FL-1617,"Pinellas County, FL",1617,2016,2017,138,4271000,218,12389000,-80,-8118000,DeKalb County,DeKalb County-Pinellas County-FL
1124,DeKalb County-Hamilton County-TN-1617,"Hamilton County, TN",1617,2016,2017,136,5059000,129,4819000,7,240000,DeKalb County,DeKalb County-Hamilton County-TN
1125,DeKalb County-Montgomery County-AL-1617,"Montgomery County, AL",1617,2016,2017,130,3259000,74,1382000,56,1877000,DeKalb County,DeKalb County-Montgomery County-AL
1126,DeKalb County-Baltimore city-MD-1617,"Baltimore city, MD",1617,2016,2017,125,4378000,107,3454000,18,924000,DeKalb County,DeKalb County-Baltimore city-MD
1127,DeKalb County-Essex County-NJ-1617,"Essex County, NJ",1617,2016,2017,128,3054000,82,1601000,46,1453000,DeKalb County,DeKalb County-Essex County-NJ
1128,DeKalb County-Carroll County-GA-1617,"Carroll County, GA",1617,2016,2017,119,2222000,133,2676000,-14,-454000,DeKalb County,DeKalb County-Carroll County-GA
1129,DeKalb County-Cuyahoga County-OH-1617,"Cuyahoga County, OH",1617,2016,2017,119,3341000,134,3309000,-15,32000,DeKalb County,DeKalb County-Cuyahoga County-OH
1130,DeKalb County-Clark County-NV-1617,"Clark County, NV",1617,2016,2017,128,2887000,179,3780000,-51,-893000,DeKalb County,DeKalb County-Clark County-NV
1131,DeKalb County-Houston County-GA-1617,"Houston County, GA",1617,2016,2017,111,2780000,134,2399000,-23,381000,DeKalb County,DeKalb County-Houston County-GA
1132,DeKalb County-Greenville County-SC-1617,"Greenville County, SC",1617,2016,2017,104,3600000,151,6028000,-47,-2428000,DeKalb County,DeKalb County-Greenville County-SC
1133,DeKalb County-Barrow County-GA-1617,"Barrow County, GA",1617,2016,2017,132,2842000,159,3674000,-27,-832000,DeKalb County,DeKalb County-Barrow County-GA
1134,DeKalb County-Jefferson County-KY-1617,"Jefferson County, KY",1617,2016,2017,129,3962000,194,3058000,-65,904000,DeKalb County,DeKalb County-Jefferson County-KY
1135,DeKalb County-Allegheny County-PA-1617,"Allegheny County, PA",1617,2016,2017,114,4120000,149,3934000,-35,186000,DeKalb County,DeKalb County-Allegheny County-PA
1136,DeKalb County-Arlington County-VA-1617,"Arlington County, VA",1617,2016,2017,93,5740000,56,2977000,37,2763000,DeKalb County,DeKalb County-Arlington County-VA
1137,DeKalb County-Madison County-AL-1617,"Madison County, AL",1617,2016,2017,103,3518000,76,2133000,27,1385000,DeKalb County,DeKalb County-Madison County-AL
1138,DeKalb County-Mobile County-AL-1617,"Mobile County, AL",1617,2016,2017,134,1661000,73,1394000,61,267000,DeKalb County,DeKalb County-Mobile County-AL
1139,DeKalb County-Marion County-IN-1617,"Marion County, IN",1617,2016,2017,105,2678000,149,2246000,-44,432000,DeKalb County,DeKalb County-Marion County-IN
1140,DeKalb County-Hamilton County-OH-1617,"Hamilton County, OH",1617,2016,2017,115,4458000,213,4820000,-98,-362000,DeKalb County,DeKalb County-Hamilton County-OH
1141,DeKalb County-Bexar County-TX-1617,"Bexar County, TX",1617,2016,2017,130,6044000,88,2318000,42,3726000,DeKalb County,DeKalb County-Bexar County-TX
1142,DeKalb County-St. Louis County-MO-1617,"St. Louis County, MO",1617,2016,2017,128,5428000,82,3549000,46,1879000,DeKalb County,DeKalb County-St. Louis County-MO
1143,DeKalb County-Tarrant County-TX-1617,"Tarrant County, TX",1617,2016,2017,132,4488000,131,3839000,1,649000,DeKalb County,DeKalb County-Tarrant County-TX
1144,DeKalb County-Knox County-TN-1617,"Knox County, TN",1617,2016,2017,96,3353000,128,3456000,-32,-103000,DeKalb County,DeKalb County-Knox County-TN
1145,DeKalb County-San Francisco County-CA-1617,"San Francisco County, CA",1617,2016,2017,104,8959000,75,5755000,29,3204000,DeKalb County,DeKalb County-San Francisco County-CA
1146,DeKalb County-Guilford County-NC-1617,"Guilford County, NC",1617,2016,2017,120,3294000,63,1420000,57,1874000,DeKalb County,DeKalb County-Guilford County-NC
1147,DeKalb County-Columbia County-GA-1617,"Columbia County, GA",1617,2016,2017,107,3654000,102,4353000,5,-699000,DeKalb County,DeKalb County-Columbia County-GA
1148,DeKalb County-Monroe County-NY-1617,"Monroe County, NY",1617,2016,2017,107,2853000,37,1327000,70,1526000,DeKalb County,DeKalb County-Monroe County-NY
1149,DeKalb County-Suffolk County-NY-1617,"Suffolk County, NY",1617,2016,2017,107,4988000,54,1174000,53,3814000,DeKalb County,DeKalb County-Suffolk County-NY
1150,DeKalb County-Santa Clara County-CA-1617,"Santa Clara County, CA",1617,2016,2017,117,6598000,124,7506000,-7,-908000,DeKalb County,DeKalb County-Santa Clara County-CA
1151,DeKalb County-Hartford County-CT-1617,"Hartford County, CT",1617,2016,2017,113,3149000,63,1840000,50,1309000,DeKalb County,DeKalb County-Hartford County-CT
1152,DeKalb County-Nassau County-NY-1617,"Nassau County, NY",1617,2016,2017,110,3294000,58,1948000,52,1346000,DeKalb County,DeKalb County-Nassau County-NY
1153,DeKalb County-Westchester County-NY-1617,"Westchester County, NY",1617,2016,2017,133,5805000,46,1211000,87,4594000,DeKalb County,DeKalb County-Westchester County-NY
1154,DeKalb County-Milwaukee County-WI-1617,"Milwaukee County, WI",1617,2016,2017,124,2584000,89,1574000,35,1010000,DeKalb County,DeKalb County-Milwaukee County-WI
1155,DeKalb County-Denver County-CO-1617,"Denver County, CO",1617,2016,2017,90,4029000,178,7969000,-88,-3940000,DeKalb County,DeKalb County-Denver County-CO
1156,DeKalb County-Bulloch County-GA-1617,"Bulloch County, GA",1617,2016,2017,88,1466000,51,943000,37,523000,DeKalb County,DeKalb County-Bulloch County-GA
1157,DeKalb County-Middlesex County-NJ-1617,"Middlesex County, NJ",1617,2016,2017,101,3269000,67,1986000,34,1283000,DeKalb County,DeKalb County-Middlesex County-NJ
1158,DeKalb County-Jefferson Parish-LA-1617,"Jefferson Parish, LA",1617,2016,2017,97,2362000,60,1298000,37,1064000,DeKalb County,DeKalb County-Jefferson Parish-LA
1159,DeKalb County-Lowndes County-GA-1617,"Lowndes County, GA",1617,2016,2017,85,2090000,49,1009000,36,1081000,DeKalb County,DeKalb County-Lowndes County-GA
1160,DeKalb County-East Baton Rouge Parish-LA-1617,"East Baton Rouge Parish, LA",1617,2016,2017,83,2260000,67,1527000,16,733000,DeKalb County,DeKalb County-East Baton Rouge Parish-LA
1161,DeKalb County-Hudson County-NJ-1617,"Hudson County, NJ",1617,2016,2017,93,5678000,57,3180000,36,2498000,DeKalb County,DeKalb County-Hudson County-NJ
1162,DeKalb County-Baltimore County-MD-1617,"Baltimore County, MD",1617,2016,2017,101,3594000,73,2146000,28,1448000,DeKalb County,DeKalb County-Baltimore County-MD
1163,DeKalb County-Hennepin County-MN-1617,"Hennepin County, MN",1617,2016,2017,83,2831000,155,4413000,-72,-1582000,DeKalb County,DeKalb County-Hennepin County-MN
1164,DeKalb County-Orange County-CA-1617,"Orange County, CA",1617,2016,2017,77,3931000,111,4734000,-34,-803000,DeKalb County,DeKalb County-Orange County-CA
1165,DeKalb County-Fairfield County-CT-1617,"Fairfield County, CT",1617,2016,2017,91,3786000,75,2560000,16,1226000,DeKalb County,DeKalb County-Fairfield County-CT
1166,DeKalb County-Cumberland County-NC-1617,"Cumberland County, NC",1617,2016,2017,95,2155000,62,1312000,33,843000,DeKalb County,DeKalb County-Cumberland County-NC
1167,DeKalb County-Buncombe County-NC-1617,"Buncombe County, NC",1617,2016,2017,65,1910000,118,5895000,-53,-3985000,DeKalb County,DeKalb County-Buncombe County-NC
1168,DeKalb County-Seminole County-FL-1617,"Seminole County, FL",1617,2016,2017,79,2610000,69,2260000,10,350000,DeKalb County,DeKalb County-Seminole County-FL
1169,DeKalb County-Bartow County-GA-1617,"Bartow County, GA",1617,2016,2017,85,2594000,111,2795000,-26,-201000,DeKalb County,DeKalb County-Bartow County-GA
1170,DeKalb County-Hinds County-MS-1617,"Hinds County, MS",1617,2016,2017,84,1283000,50,812000,34,471000,DeKalb County,DeKalb County-Hinds County-MS
1171,DeKalb County-Erie County-NY-1617,"Erie County, NY",1617,2016,2017,83,1889000,47,813000,36,1076000,DeKalb County,DeKalb County-Erie County-NY
1172,DeKalb County-Forsyth County-NC-1617,"Forsyth County, NC",1617,2016,2017,63,2399000,37,1802000,26,597000,DeKalb County,DeKalb County-Forsyth County-NC
1173,DeKalb County-Glynn County-GA-1617,"Glynn County, GA",1617,2016,2017,78,1931000,133,5786000,-55,-3855000,DeKalb County,DeKalb County-Glynn County-GA
1174,DeKalb County-Lee County-AL-1617,"Lee County, AL",1617,2016,2017,68,1627000,56,1971000,12,-344000,DeKalb County,DeKalb County-Lee County-AL
1175,DeKalb County-Sacramento County-CA-1617,"Sacramento County, CA",1617,2016,2017,90,2349000,70,1602000,20,747000,DeKalb County,DeKalb County-Sacramento County-CA
1176,DeKalb County-Escambia County-FL-1617,"Escambia County, FL",1617,2016,2017,81,2172000,98,4080000,-17,-1908000,DeKalb County,DeKalb County-Escambia County-FL
1177,DeKalb County-Jackson County-MO-1617,"Jackson County, MO",1617,2016,2017,79,1700000,42,571000,37,1129000,DeKalb County,DeKalb County-Jackson County-MO
1178,DeKalb County-Collin County-TX-1617,"Collin County, TX",1617,2016,2017,83,3274000,108,3652000,-25,-378000,DeKalb County,DeKalb County-Collin County-TX
1179,DeKalb County-Pulaski County-AR-1617,"Pulaski County, AR",1617,2016,2017,77,2831000,49,1417000,28,1414000,DeKalb County,DeKalb County-Pulaski County-AR
1180,DeKalb County-Brevard County-FL-1617,"Brevard County, FL",1617,2016,2017,68,1325000,72,3750000,-4,-2425000,DeKalb County,DeKalb County-Brevard County-FL
1181,DeKalb County-Lee County-FL-1617,"Lee County, FL",1617,2016,2017,74,2423000,72,2511000,2,-88000,DeKalb County,DeKalb County-Lee County-FL
1182,DeKalb County-Alexandria city-VA-1617,"Alexandria city, VA",1617,2016,2017,65,3652000,51,2336000,14,1316000,DeKalb County,DeKalb County-Alexandria city-VA
1183,DeKalb County-Norfolk County-MA-1617,"Norfolk County, MA",1617,2016,2017,78,4758000,58,3504000,20,1254000,DeKalb County,DeKalb County-Norfolk County-MA
1184,DeKalb County-Beaufort County-SC-1617,"Beaufort County, SC",1617,2016,2017,75,3044000,88,7886000,-13,-4842000,DeKalb County,DeKalb County-Beaufort County-SC
1185,DeKalb County-Volusia County-FL-1617,"Volusia County, FL",1617,2016,2017,63,1511000,72,2327000,-9,-816000,DeKalb County,DeKalb County-Volusia County-FL
1186,DeKalb County-Spalding County-GA-1617,"Spalding County, GA",1617,2016,2017,68,2296000,93,1532000,-25,764000,DeKalb County,DeKalb County-Spalding County-GA
1187,DeKalb County-Multnomah County-OR-1617,"Multnomah County, OR",1617,2016,2017,70,3101000,76,3014000,-6,87000,DeKalb County,DeKalb County-Multnomah County-OR
1188,DeKalb County-Richmond city-VA-1617,"Richmond city, VA",1617,2016,2017,61,1832000,55,1641000,6,191000,DeKalb County,DeKalb County-Richmond city-VA
1189,DeKalb County-San Bernardino County-CA-1617,"San Bernardino County, CA",1617,2016,2017,72,1517000,73,1397000,-1,120000,DeKalb County,DeKalb County-San Bernardino County-CA
1190,DeKalb County-Bergen County-NJ-1617,"Bergen County, NJ",1617,2016,2017,66,2935000,51,2362000,15,573000,DeKalb County,DeKalb County-Bergen County-NJ
1191,DeKalb County-Henrico County-VA-1617,"Henrico County, VA",1617,2016,2017,64,2425000,60,2517000,4,-92000,DeKalb County,DeKalb County-Henrico County-VA
1192,DeKalb County-Polk County-FL-1617,"Polk County, FL",1617,2016,2017,59,1295000,69,1991000,-10,-696000,DeKalb County,DeKalb County-Polk County-FL
1193,DeKalb County-Montgomery County-PA-1617,"Montgomery County, PA",1617,2016,2017,53,2135000,37,1917000,16,218000,DeKalb County,DeKalb County-Montgomery County-PA
1194,DeKalb County-New Haven County-CT-1617,"New Haven County, CT",1617,2016,2017,70,2279000,61,2288000,9,-9000,DeKalb County,DeKalb County-New Haven County-CT
1195,DeKalb County-Washtenaw County-MI-1617,"Washtenaw County, MI",1617,2016,2017,65,2206000,42,2200000,23,6000,DeKalb County,DeKalb County-Washtenaw County-MI
1196,DeKalb County-Salt Lake County-UT-1617,"Salt Lake County, UT",1617,2016,2017,57,2000000,88,3346000,-31,-1346000,DeKalb County,DeKalb County-Salt Lake County-UT
1197,DeKalb County-Norfolk city-VA-1617,"Norfolk city, VA",1617,2016,2017,63,1467000,53,939000,10,528000,DeKalb County,DeKalb County-Norfolk city-VA
1198,DeKalb County-Shelby County-AL-1617,"Shelby County, AL",1617,2016,2017,61,2146000,45,1328000,16,818000,DeKalb County,DeKalb County-Shelby County-AL
1199,DeKalb County-DuPage County-IL-1617,"DuPage County, IL",1617,2016,2017,57,2572000,84,3605000,-27,-1033000,DeKalb County,DeKalb County-DuPage County-IL
1200,DeKalb County-Contra Costa County-CA-1617,"Contra Costa County, CA",1617,2016,2017,63,2921000,42,1695000,21,1226000,DeKalb County,DeKalb County-Contra Costa County-CA
1201,DeKalb County-Douglas County-NE-1617,"Douglas County, NE",1617,2016,2017,70,2679000,71,1434000,-1,1245000,DeKalb County,DeKalb County-Douglas County-NE
1202,DeKalb County-Denton County-TX-1617,"Denton County, TX",1617,2016,2017,78,3736000,63,2930000,15,806000,DeKalb County,DeKalb County-Denton County-TX
1203,DeKalb County-Liberty County-GA-1617,"Liberty County, GA",1617,2016,2017,57,1099000,52,722000,5,377000,DeKalb County,DeKalb County-Liberty County-GA
1204,DeKalb County-Fayette County-KY-1617,"Fayette County, KY",1617,2016,2017,44,1334000,54,1314000,-10,20000,DeKalb County,DeKalb County-Fayette County-KY
1205,DeKalb County-Riverside County-CA-1617,"Riverside County, CA",1617,2016,2017,60,1646000,66,1640000,-6,6000,DeKalb County,DeKalb County-Riverside County-CA
1206,DeKalb County-Troup County-GA-1617,"Troup County, GA",1617,2016,2017,63,940000,65,970000,-2,-30000,DeKalb County,DeKalb County-Troup County-GA
1207,DeKalb County-Honolulu County-HI-1617,"Honolulu County, HI",1617,2016,2017,48,1856000,45,1358000,3,498000,DeKalb County,DeKalb County-Honolulu County-HI
1208,DeKalb County-Kent County-MI-1617,"Kent County, MI",1617,2016,2017,62,1096000,49,1219000,13,-123000,DeKalb County,DeKalb County-Kent County-MI
1209,DeKalb County-Arapahoe County-CO-1617,"Arapahoe County, CO",1617,2016,2017,54,1753000,69,2540000,-15,-787000,DeKalb County,DeKalb County-Arapahoe County-CO
1210,DeKalb County-Montgomery County-OH-1617,"Montgomery County, OH",1617,2016,2017,55,780000,49,1096000,6,-316000,DeKalb County,DeKalb County-Montgomery County-OH
1211,DeKalb County-El Paso County-CO-1617,"El Paso County, CO",1617,2016,2017,49,1820000,44,1539000,5,281000,DeKalb County,DeKalb County-El Paso County-CO
1212,DeKalb County-Floyd County-GA-1617,"Floyd County, GA",1617,2016,2017,47,1449000,68,1394000,-21,55000,DeKalb County,DeKalb County-Floyd County-GA
1213,DeKalb County-St. Louis city-MO-1617,"St. Louis city, MO",1617,2016,2017,43,1453000,40,1205000,3,248000,DeKalb County,DeKalb County-St. Louis city-MO
1214,DeKalb County-Virginia Beach city-VA-1617,"Virginia Beach city, VA",1617,2016,2017,49,961000,63,1346000,-14,-385000,DeKalb County,DeKalb County-Virginia Beach city-VA
1215,DeKalb County-Manatee County-FL-1617,"Manatee County, FL",1617,2016,2017,52,1533000,57,2679000,-5,-1146000,DeKalb County,DeKalb County-Manatee County-FL
1216,DeKalb County-St. Lucie County-FL-1617,"St. Lucie County, FL",1617,2016,2017,60,662000,38,905000,22,-243000,DeKalb County,DeKalb County-St. Lucie County-FL
1217,DeKalb County-Jackson County-GA-1617,"Jackson County, GA",1617,2016,2017,50,1802000,59,2136000,-9,-334000,DeKalb County,DeKalb County-Jackson County-GA
1218,DeKalb County-Ramsey County-MN-1617,"Ramsey County, MN",1617,2016,2017,56,1229000,82,1633000,-26,-404000,DeKalb County,DeKalb County-Ramsey County-MN
1219,DeKalb County-New Hanover County-NC-1617,"New Hanover County, NC",1617,2016,2017,46,1564000,36,1995000,10,-431000,DeKalb County,DeKalb County-New Hanover County-NC
1220,DeKalb County-Dane County-WI-1617,"Dane County, WI",1617,2016,2017,54,1960000,59,2212000,-5,-252000,DeKalb County,DeKalb County-Dane County-WI
1221,DeKalb County-Pima County-AZ-1617,"Pima County, AZ",1617,2016,2017,45,1241000,36,1136000,9,105000,DeKalb County,DeKalb County-Pima County-AZ
1222,DeKalb County-Sarasota County-FL-1617,"Sarasota County, FL",1617,2016,2017,42,1657000,44,2586000,-2,-929000,DeKalb County,DeKalb County-Sarasota County-FL
1223,DeKalb County-Loudoun County-VA-1617,"Loudoun County, VA",1617,2016,2017,48,2340000,96,4543000,-48,-2203000,DeKalb County,DeKalb County-Loudoun County-VA
1224,DeKalb County-Marion County-FL-1617,"Marion County, FL",1617,2016,2017,50,907000,38,853000,12,54000,DeKalb County,DeKalb County-Marion County-FL
1225,DeKalb County-Baldwin County-AL-1617,"Baldwin County, AL",1617,2016,2017,37,1208000,42,1560000,-5,-352000,DeKalb County,DeKalb County-Baldwin County-AL
1226,DeKalb County-Osceola County-FL-1617,"Osceola County, FL",1617,2016,2017,40,1011000,48,777000,-8,234000,DeKalb County,DeKalb County-Osceola County-FL
1227,DeKalb County-Dawson County-GA-1617,"Dawson County, GA",1617,2016,2017,32,885000,34,1597000,-2,-712000,DeKalb County,DeKalb County-Dawson County-GA
1228,DeKalb County-Anne Arundel County-MD-1617,"Anne Arundel County, MD",1617,2016,2017,38,2004000,40,2196000,-2,-192000,DeKalb County,DeKalb County-Anne Arundel County-MD
1229,DeKalb County-Aiken County-SC-1617,"Aiken County, SC",1617,2016,2017,43,1055000,37,1054000,6,1000,DeKalb County,DeKalb County-Aiken County-SC
1230,DeKalb County-Fort Bend County-TX-1617,"Fort Bend County, TX",1617,2016,2017,47,1966000,40,1167000,7,799000,DeKalb County,DeKalb County-Fort Bend County-TX
1231,DeKalb County-Pierce County-WA-1617,"Pierce County, WA",1617,2016,2017,45,864000,60,1961000,-15,-1097000,DeKalb County,DeKalb County-Pierce County-WA
1232,DeKalb County-Harrison County-MS-1617,"Harrison County, MS",1617,2016,2017,38,993000,38,912000,0,81000,DeKalb County,DeKalb County-Harrison County-MS
1233,DeKalb County-Prince William County-VA-1617,"Prince William County, VA",1617,2016,2017,31,1626000,43,1253000,-12,373000,DeKalb County,DeKalb County-Prince William County-VA
1234,DeKalb County-Boulder County-CO-1617,"Boulder County, CO",1617,2016,2017,27,772000,67,4253000,-40,-3481000,DeKalb County,DeKalb County-Boulder County-CO
1235,DeKalb County-Delaware County-PA-1617,"Delaware County, PA",1617,2016,2017,44,1465000,55,1542000,-11,-77000,DeKalb County,DeKalb County-Delaware County-PA
1236,DeKalb County-Spartanburg County-SC-1617,"Spartanburg County, SC",1617,2016,2017,41,1012000,50,845000,-9,167000,DeKalb County,DeKalb County-Spartanburg County-SC
1237,DeKalb County-Montgomery County-TN-1617,"Montgomery County, TN",1617,2016,2017,41,515000,48,677000,-7,-162000,DeKalb County,DeKalb County-Montgomery County-TN
1239,Douglas County-Cobb County-GA-1617,"Cobb County, GA",1617,2016,2017,3596,60061000,2295,48542000,1301,11519000,Douglas County,Douglas County-Cobb County-GA
1240,Douglas County-Fulton County-GA-1617,"Fulton County, GA",1617,2016,2017,1963,35628000,1771,37410000,192,-1782000,Douglas County,Douglas County-Fulton County-GA
1241,Douglas County-Paulding County-GA-1617,"Paulding County, GA",1617,2016,2017,1272,23760000,1610,31445000,-338,-7685000,Douglas County,Douglas County-Paulding County-GA
1242,Douglas County-Carroll County-GA-1617,"Carroll County, GA",1617,2016,2017,1124,26202000,1600,37645000,-476,-11443000,Douglas County,Douglas County-Carroll County-GA
1243,Douglas County-DeKalb County-GA-1617,"DeKalb County, GA",1617,2016,2017,621,11599000,543,11875000,78,-276000,Douglas County,Douglas County-DeKalb County-GA
1244,Douglas County-Clayton County-GA-1617,"Clayton County, GA",1617,2016,2017,451,6553000,430,5262000,21,1291000,Douglas County,Douglas County-Clayton County-GA
1245,Douglas County-Gwinnett County-GA-1617,"Gwinnett County, GA",1617,2016,2017,368,7745000,399,8813000,-31,-1068000,Douglas County,Douglas County-Gwinnett County-GA
1246,Douglas County-Henry County-GA-1617,"Henry County, GA",1617,2016,2017,170,3806000,227,4368000,-57,-562000,Douglas County,Douglas County-Henry County-GA
1247,Douglas County-Broward County-FL-1617,"Broward County, FL",1617,2016,2017,119,2427000,53,1272000,66,1155000,Douglas County,Douglas County-Broward County-FL
1248,Douglas County-Coweta County-GA-1617,"Coweta County, GA",1617,2016,2017,103,3476000,215,6623000,-112,-3147000,Douglas County,Douglas County-Coweta County-GA
1249,Douglas County-Cook County-IL-1617,"Cook County, IL",1617,2016,2017,86,1893000,48,954000,38,939000,Douglas County,Douglas County-Cook County-IL
1250,Douglas County-Cherokee County-GA-1617,"Cherokee County, GA",1617,2016,2017,63,2151000,174,5973000,-111,-3822000,Douglas County,Douglas County-Cherokee County-GA
1251,Douglas County-Haralson County-GA-1617,"Haralson County, GA",1617,2016,2017,86,1426000,223,3969000,-137,-2543000,Douglas County,Douglas County-Haralson County-GA
1252,Douglas County-Los Angeles County-CA-1617,"Los Angeles County, CA",1617,2016,2017,60,834000,37,1172000,23,-338000,Douglas County,Douglas County-Los Angeles County-CA
1253,Douglas County-Jefferson County-AL-1617,"Jefferson County, AL",1617,2016,2017,65,1117000,60,1643000,5,-526000,Douglas County,Douglas County-Jefferson County-AL
1254,Douglas County-Fayette County-GA-1617,"Fayette County, GA",1617,2016,2017,65,1474000,86,4352000,-21,-2878000,Douglas County,Douglas County-Fayette County-GA
1255,Douglas County-Chatham County-GA-1617,"Chatham County, GA",1617,2016,2017,60,1082000,58,1461000,2,-379000,Douglas County,Douglas County-Chatham County-GA
1256,Douglas County-Orange County-FL-1617,"Orange County, FL",1617,2016,2017,59,715000,49,1052000,10,-337000,Douglas County,Douglas County-Orange County-FL
1257,Douglas County-Newton County-GA-1617,"Newton County, GA",1617,2016,2017,75,1065000,53,1148000,22,-83000,Douglas County,Douglas County-Newton County-GA
1258,Douglas County-Hillsborough County-FL-1617,"Hillsborough County, FL",1617,2016,2017,66,1493000,62,1370000,4,123000,Douglas County,Douglas County-Hillsborough County-FL
1259,Douglas County-Duval County-FL-1617,"Duval County, FL",1617,2016,2017,55,1007000,47,932000,8,75000,Douglas County,Douglas County-Duval County-FL
1260,Douglas County-Harris County-TX-1617,"Harris County, TX",1617,2016,2017,46,734000,46,800000,0,-66000,Douglas County,Douglas County-Harris County-TX
1261,Douglas County-Rockdale County-GA-1617,"Rockdale County, GA",1617,2016,2017,41,878000,50,807000,-9,71000,Douglas County,Douglas County-Rockdale County-GA
1263,Fayette County-Fulton County-GA-1617,"Fulton County, GA",1617,2016,2017,1435,55705000,1012,45854000,423,9851000,Fayette County,Fayette County-Fulton County-GA
1264,Fayette County-Clayton County-GA-1617,"Clayton County, GA",1617,2016,2017,1409,26502000,594,8968000,815,17534000,Fayette County,Fayette County-Clayton County-GA
1265,Fayette County-Coweta County-GA-1617,"Coweta County, GA",1617,2016,2017,1192,39028000,2057,80744000,-865,-41716000,Fayette County,Fayette County-Coweta County-GA
1266,Fayette County-Henry County-GA-1617,"Henry County, GA",1617,2016,2017,495,14158000,354,9131000,141,5027000,Fayette County,Fayette County-Henry County-GA
1267,Fayette County-Cobb County-GA-1617,"Cobb County, GA",1617,2016,2017,422,15484000,377,16259000,45,-775000,Fayette County,Fayette County-Cobb County-GA
1268,Fayette County-DeKalb County-GA-1617,"DeKalb County, GA",1617,2016,2017,321,11687000,275,11858000,46,-171000,Fayette County,Fayette County-DeKalb County-GA
1269,Fayette County-Los Angeles County-CA-1617,"Los Angeles County, CA",1617,2016,2017,206,9124000,44,1855000,162,7269000,Fayette County,Fayette County-Los Angeles County-CA
1270,Fayette County-Gwinnett County-GA-1617,"Gwinnett County, GA",1617,2016,2017,183,6257000,161,3706000,22,2551000,Fayette County,Fayette County-Gwinnett County-GA
1271,Fayette County-Spalding County-GA-1617,"Spalding County, GA",1617,2016,2017,171,4948000,223,6932000,-52,-1984000,Fayette County,Fayette County-Spalding County-GA
1272,Fayette County-Douglas County-GA-1617,"Douglas County, GA",1617,2016,2017,86,4352000,65,1474000,21,2878000,Fayette County,Fayette County-Douglas County-GA
1273,Fayette County-Cook County-IL-1617,"Cook County, IL",1617,2016,2017,72,2854000,33,1200000,39,1654000,Fayette County,Fayette County-Cook County-IL
1274,Fayette County-Carroll County-GA-1617,"Carroll County, GA",1617,2016,2017,64,1625000,57,1400000,7,225000,Fayette County,Fayette County-Carroll County-GA
1275,Fayette County-Cherokee County-GA-1617,"Cherokee County, GA",1617,2016,2017,58,1714000,79,3550000,-21,-1836000,Fayette County,Fayette County-Cherokee County-GA
1276,Fayette County-Paulding County-GA-1617,"Paulding County, GA",1617,2016,2017,76,2507000,62,1529000,14,978000,Fayette County,Fayette County-Paulding County-GA
1277,Fayette County-Meriwether County-GA-1617,"Meriwether County, GA",1617,2016,2017,57,926000,52,1786000,5,-860000,Fayette County,Fayette County-Meriwether County-GA
1278,Fayette County-Maricopa County-AZ-1617,"Maricopa County, AZ",1617,2016,2017,50,3003000,40,1702000,10,1301000,Fayette County,Fayette County-Maricopa County-AZ
1279,Fayette County-Chatham County-GA-1617,"Chatham County, GA",1617,2016,2017,56,2230000,47,1769000,9,461000,Fayette County,Fayette County-Chatham County-GA
1280,Fayette County-Oakland County-MI-1617,"Oakland County, MI",1617,2016,2017,50,1929000,64,2661000,-14,-732000,Fayette County,Fayette County-Oakland County-MI
1281,Fayette County-Pike County-GA-1617,"Pike County, GA",1617,2016,2017,52,1216000,92,3524000,-40,-2308000,Fayette County,Fayette County-Pike County-GA
1282,Fayette County-Forsyth County-GA-1617,"Forsyth County, GA",1617,2016,2017,51,3045000,74,2816000,-23,229000,Fayette County,Fayette County-Forsyth County-GA
1284,Forsyth County-Fulton County-GA-1617,"Fulton County, GA",1617,2016,2017,7458,310721000,2945,170750000,4513,139971000,Forsyth County,Forsyth County-Fulton County-GA
1285,Forsyth County-Gwinnett County-GA-1617,"Gwinnett County, GA",1617,2016,2017,3475,130829000,1720,59323000,1755,71506000,Forsyth County,Forsyth County-Gwinnett County-GA
1286,Forsyth County-Cobb County-GA-1617,"Cobb County, GA",1617,2016,2017,1472,58113000,526,20655000,946,37458000,Forsyth County,Forsyth County-Cobb County-GA
1287,Forsyth County-DeKalb County-GA-1617,"DeKalb County, GA",1617,2016,2017,1368,56123000,380,18958000,988,37165000,Forsyth County,Forsyth County-DeKalb County-GA
1288,Forsyth County-Cherokee County-GA-1617,"Cherokee County, GA",1617,2016,2017,784,30843000,1027,43405000,-243,-12562000,Forsyth County,Forsyth County-Cherokee County-GA
1289,Forsyth County-Hall County-GA-1617,"Hall County, GA",1617,2016,2017,628,21712000,955,35692000,-327,-13980000,Forsyth County,Forsyth County-Hall County-GA
1290,Forsyth County-Dawson County-GA-1617,"Dawson County, GA",1617,2016,2017,619,14314000,1073,31790000,-454,-17476000,Forsyth County,Forsyth County-Dawson County-GA
1291,Forsyth County-Lumpkin County-GA-1617,"Lumpkin County, GA",1617,2016,2017,229,5980000,445,13174000,-216,-7194000,Forsyth County,Forsyth County-Lumpkin County-GA
1292,Forsyth County-Broward County-FL-1617,"Broward County, FL",1617,2016,2017,200,8017000,90,3058000,110,4959000,Forsyth County,Forsyth County-Broward County-FL
1293,Forsyth County-Palm Beach County-FL-1617,"Palm Beach County, FL",1617,2016,2017,151,6740000,81,3965000,70,2775000,Forsyth County,Forsyth County-Palm Beach County-FL
1294,Forsyth County-Los Angeles County-CA-1617,"Los Angeles County, CA",1617,2016,2017,109,4955000,50,1936000,59,3019000,Forsyth County,Forsyth County-Los Angeles County-CA
1295,Forsyth County-Hillsborough County-FL-1617,"Hillsborough County, FL",1617,2016,2017,118,4830000,95,3534000,23,1296000,Forsyth County,Forsyth County-Hillsborough County-FL
1296,Forsyth County-Barrow County-GA-1617,"Barrow County, GA",1617,2016,2017,108,2791000,95,2486000,13,305000,Forsyth County,Forsyth County-Barrow County-GA
1297,Forsyth County-Maricopa County-AZ-1617,"Maricopa County, AZ",1617,2016,2017,136,4341000,110,6406000,26,-2065000,Forsyth County,Forsyth County-Maricopa County-AZ
1298,Forsyth County-Pickens County-GA-1617,"Pickens County, GA",1617,2016,2017,101,3280000,158,6876000,-57,-3596000,Forsyth County,Forsyth County-Pickens County-GA
1299,Forsyth County-Mecklenburg County-NC-1617,"Mecklenburg County, NC",1617,2016,2017,98,4455000,66,3728000,32,727000,Forsyth County,Forsyth County-Mecklenburg County-NC
1300,Forsyth County-Duval County-FL-1617,"Duval County, FL",1617,2016,2017,90,5429000,45,3231000,45,2198000,Forsyth County,Forsyth County-Duval County-FL
1301,Forsyth County-Clarke County-GA-1617,"Clarke County, GA",1617,2016,2017,51,1436000,68,1600000,-17,-164000,Forsyth County,Forsyth County-Clarke County-GA
1302,Forsyth County-Paulding County-GA-1617,"Paulding County, GA",1617,2016,2017,87,3431000,57,1966000,30,1465000,Forsyth County,Forsyth County-Paulding County-GA
1303,Forsyth County-Harris County-TX-1617,"Harris County, TX",1617,2016,2017,100,5376000,72,4029000,28,1347000,Forsyth County,Forsyth County-Harris County-TX
1304,Forsyth County-Orange County-FL-1617,"Orange County, FL",1617,2016,2017,86,3145000,79,3275000,7,-130000,Forsyth County,Forsyth County-Orange County-FL
1305,Forsyth County-Wake County-NC-1617,"Wake County, NC",1617,2016,2017,89,4614000,108,5562000,-19,-948000,Forsyth County,Forsyth County-Wake County-NC
1306,Forsyth County-Collin County-TX-1617,"Collin County, TX",1617,2016,2017,110,3984000,90,4734000,20,-750000,Forsyth County,Forsyth County-Collin County-TX
1307,Forsyth County-Orange County-CA-1617,"Orange County, CA",1617,2016,2017,88,5092000,57,2997000,31,2095000,Forsyth County,Forsyth County-Orange County-CA
1308,Forsyth County-Chatham County-GA-1617,"Chatham County, GA",1617,2016,2017,63,1617000,41,1517000,22,100000,Forsyth County,Forsyth County-Chatham County-GA
1309,Forsyth County-Pinellas County-FL-1617,"Pinellas County, FL",1617,2016,2017,55,2079000,73,3274000,-18,-1195000,Forsyth County,Forsyth County-Pinellas County-FL
1310,Forsyth County-Coweta County-GA-1617,"Coweta County, GA",1617,2016,2017,72,2059000,54,1685000,18,374000,Forsyth County,Forsyth County-Coweta County-GA
1311,Forsyth County-San Diego County-CA-1617,"San Diego County, CA",1617,2016,2017,75,2101000,41,1616000,34,485000,Forsyth County,Forsyth County-San Diego County-CA
1312,Forsyth County-Fayette County-GA-1617,"Fayette County, GA",1617,2016,2017,74,2816000,51,3045000,23,-229000,Forsyth County,Forsyth County-Fayette County-GA
1313,Forsyth County-Jackson County-GA-1617,"Jackson County, GA",1617,2016,2017,57,1767000,89,2461000,-32,-694000,Forsyth County,Forsyth County-Jackson County-GA
1314,Forsyth County-Hamilton County-TN-1617,"Hamilton County, TN",1617,2016,2017,70,2286000,53,1806000,17,480000,Forsyth County,Forsyth County-Hamilton County-TN
1315,Forsyth County-King County-WA-1617,"King County, WA",1617,2016,2017,66,2765000,58,4656000,8,-1891000,Forsyth County,Forsyth County-King County-WA
1316,Forsyth County-Bartow County-GA-1617,"Bartow County, GA",1617,2016,2017,42,1131000,72,1879000,-30,-748000,Forsyth County,Forsyth County-Bartow County-GA
1317,Forsyth County-Walton County-GA-1617,"Walton County, GA",1617,2016,2017,39,1074000,58,2073000,-19,-999000,Forsyth County,Forsyth County-Walton County-GA
1318,Forsyth County-Greenville County-SC-1617,"Greenville County, SC",1617,2016,2017,67,2760000,74,2801000,-7,-41000,Forsyth County,Forsyth County-Greenville County-SC
1319,Forsyth County-Clark County-NV-1617,"Clark County, NV",1617,2016,2017,44,1431000,55,2046000,-11,-615000,Forsyth County,Forsyth County-Clark County-NV
1320,Forsyth County-White County-GA-1617,"White County, GA",1617,2016,2017,34,909000,119,5287000,-85,-4378000,Forsyth County,Forsyth County-White County-GA
1322,Fulton County-DeKalb County-GA-1617,"DeKalb County, GA",1617,2016,2017,17757,956592000,17822,907964000,-65,48628000,Fulton County,Fulton County-DeKalb County-GA
1323,Fulton County-Cobb County-GA-1617,"Cobb County, GA",1617,2016,2017,11711,491715000,11525,467876000,186,23839000,Fulton County,Fulton County-Cobb County-GA
1324,Fulton County-Gwinnett County-GA-1617,"Gwinnett County, GA",1617,2016,2017,7320,304663000,7997,241477000,-677,63186000,Fulton County,Fulton County-Gwinnett County-GA
1325,Fulton County-Clayton County-GA-1617,"Clayton County, GA",1617,2016,2017,7239,94527000,8445,98837000,-1206,-4310000,Fulton County,Fulton County-Clayton County-GA
1326,Fulton County-Forsyth County-GA-1617,"Forsyth County, GA",1617,2016,2017,2945,170750000,7458,310721000,-4513,-139971000,Fulton County,Fulton County-Forsyth County-GA
1327,Fulton County-Cherokee County-GA-1617,"Cherokee County, GA",1617,2016,2017,1631,78826000,3257,108232000,-1626,-29406000,Fulton County,Fulton County-Cherokee County-GA
1328,Fulton County-Douglas County-GA-1617,"Douglas County, GA",1617,2016,2017,1771,37410000,1963,35628000,-192,1782000,Fulton County,Fulton County-Douglas County-GA
1329,Fulton County-Henry County-GA-1617,"Henry County, GA",1617,2016,2017,1452,39618000,1641,35001000,-189,4617000,Fulton County,Fulton County-Henry County-GA
1330,Fulton County-Cook County-IL-1617,"Cook County, IL",1617,2016,2017,1192,103646000,870,54497000,322,49149000,Fulton County,Fulton County-Cook County-IL
1331,Fulton County-Los Angeles County-CA-1617,"Los Angeles County, CA",1617,2016,2017,948,50663000,847,58144000,101,-7481000,Fulton County,Fulton County-Los Angeles County-CA
1332,Fulton County-Fayette County-GA-1617,"Fayette County, GA",1617,2016,2017,1012,45854000,1435,55705000,-423,-9851000,Fulton County,Fulton County-Fayette County-GA
1333,Fulton County-Coweta County-GA-1617,"Coweta County, GA",1617,2016,2017,1023,28208000,1183,33505000,-160,-5297000,Fulton County,Fulton County-Coweta County-GA
1334,Fulton County-New York County-NY-1617,"New York County, NY",1617,2016,2017,670,77486000,565,58459000,105,19027000,Fulton County,Fulton County-New York County-NY
1335,Fulton County-Broward County-FL-1617,"Broward County, FL",1617,2016,2017,871,33951000,444,27764000,427,6187000,Fulton County,Fulton County-Broward County-FL
1336,Fulton County-Mecklenburg County-NC-1617,"Mecklenburg County, NC",1617,2016,2017,762,42951000,570,31250000,192,11701000,Fulton County,Fulton County-Mecklenburg County-NC
1337,Fulton County-Miami-Dade County-FL-1617,"Miami-Dade County, FL",1617,2016,2017,763,57080000,392,18903000,371,38177000,Fulton County,Fulton County-Miami-Dade County-FL
1338,Fulton County-Kings County-NY-1617,"Kings County, NY",1617,2016,2017,567,26668000,313,13151000,254,13517000,Fulton County,Fulton County-Kings County-NY
1339,Fulton County-Harris County-TX-1617,"Harris County, TX",1617,2016,2017,576,34609000,403,19001000,173,15608000,Fulton County,Fulton County-Harris County-TX
1340,Fulton County-Clarke County-GA-1617,"Clarke County, GA",1617,2016,2017,451,13109000,318,11537000,133,1572000,Fulton County,Fulton County-Clarke County-GA
1341,Fulton County-Chatham County-GA-1617,"Chatham County, GA",1617,2016,2017,498,15908000,348,12482000,150,3426000,Fulton County,Fulton County-Chatham County-GA
1342,Fulton County-Orange County-FL-1617,"Orange County, FL",1617,2016,2017,545,19792000,398,18703000,147,1089000,Fulton County,Fulton County-Orange County-FL
1343,Fulton County-Dallas County-TX-1617,"Dallas County, TX",1617,2016,2017,514,35224000,572,38898000,-58,-3674000,Fulton County,Fulton County-Dallas County-TX
1344,Fulton County-Hillsborough County-FL-1617,"Hillsborough County, FL",1617,2016,2017,542,20939000,439,20331000,103,608000,Fulton County,Fulton County-Hillsborough County-FL
1345,Fulton County-Jefferson County-AL-1617,"Jefferson County, AL",1617,2016,2017,468,22094000,330,20201000,138,1893000,Fulton County,Fulton County-Jefferson County-AL
1346,Fulton County-Travis County-TX-1617,"Travis County, TX",1617,2016,2017,494,18578000,368,18022000,126,556000,Fulton County,Fulton County-Travis County-TX
1347,Fulton County-Duval County-FL-1617,"Duval County, FL",1617,2016,2017,444,19344000,436,23364000,8,-4020000,Fulton County,Fulton County-Duval County-FL
1348,Fulton County-Paulding County-GA-1617,"Paulding County, GA",1617,2016,2017,486,13955000,540,11320000,-54,2635000,Fulton County,Fulton County-Paulding County-GA
1349,Fulton County-Wake County-NC-1617,"Wake County, NC",1617,2016,2017,461,26815000,364,22408000,97,4407000,Fulton County,Fulton County-Wake County-NC
1350,Fulton County-Davidson County-TN-1617,"Davidson County, TN",1617,2016,2017,359,16461000,365,22277000,-6,-5816000,Fulton County,Fulton County-Davidson County-TN
1351,Fulton County-Rockdale County-GA-1617,"Rockdale County, GA",1617,2016,2017,444,11677000,478,9277000,-34,2400000,Fulton County,Fulton County-Rockdale County-GA
1352,Fulton County-Palm Beach County-FL-1617,"Palm Beach County, FL",1617,2016,2017,454,24752000,357,19113000,97,5639000,Fulton County,Fulton County-Palm Beach County-FL
1353,Fulton County-District of Columbia-DC-1617,"District of Columbia, DC",1617,2016,2017,342,23343000,371,25370000,-29,-2027000,Fulton County,Fulton County-District of Columbia-DC
1354,Fulton County-Shelby County-TN-1617,"Shelby County, TN",1617,2016,2017,401,16781000,217,10304000,184,6477000,Fulton County,Fulton County-Shelby County-TN
1355,Fulton County-Muscogee County-GA-1617,"Muscogee County, GA",1617,2016,2017,405,12719000,231,7527000,174,5192000,Fulton County,Fulton County-Muscogee County-GA
1356,Fulton County-Maricopa County-AZ-1617,"Maricopa County, AZ",1617,2016,2017,416,30612000,373,22806000,43,7806000,Fulton County,Fulton County-Maricopa County-AZ
1357,Fulton County-Hall County-GA-1617,"Hall County, GA",1617,2016,2017,311,15830000,464,31167000,-153,-15337000,Fulton County,Fulton County-Hall County-GA
1358,Fulton County-Queens County-NY-1617,"Queens County, NY",1617,2016,2017,353,12744000,155,6065000,198,6679000,Fulton County,Fulton County-Queens County-NY
1359,Fulton County-Bibb County-GA-1617,"Bibb County, GA",1617,2016,2017,314,10473000,243,6345000,71,4128000,Fulton County,Fulton County-Bibb County-GA
1360,Fulton County-Philadelphia County-PA-1617,"Philadelphia County, PA",1617,2016,2017,274,11980000,211,10376000,63,1604000,Fulton County,Fulton County-Philadelphia County-PA
1361,Fulton County-Newton County-GA-1617,"Newton County, GA",1617,2016,2017,315,7003000,376,7109000,-61,-106000,Fulton County,Fulton County-Newton County-GA
1362,Fulton County-Leon County-FL-1617,"Leon County, FL",1617,2016,2017,248,8553000,119,4240000,129,4313000,Fulton County,Fulton County-Leon County-FL
1363,Fulton County-Prince George's County-MD-1617,"Prince George's County, MD",1617,2016,2017,254,9713000,136,4372000,118,5341000,Fulton County,Fulton County-Prince George's County-MD
1364,Fulton County-San Diego County-CA-1617,"San Diego County, CA",1617,2016,2017,314,17327000,238,11774000,76,5553000,Fulton County,Fulton County-San Diego County-CA
1365,Fulton County-Alameda County-CA-1617,"Alameda County, CA",1617,2016,2017,297,15077000,240,13493000,57,1584000,Fulton County,Fulton County-Alameda County-CA
1366,Fulton County-King County-WA-1617,"King County, WA",1617,2016,2017,297,20351000,553,41813000,-256,-21462000,Fulton County,Fulton County-King County-WA
1367,Fulton County-Carroll County-GA-1617,"Carroll County, GA",1617,2016,2017,273,6844000,275,4938000,-2,1906000,Fulton County,Fulton County-Carroll County-GA
1368,Fulton County-Suffolk County-MA-1617,"Suffolk County, MA",1617,2016,2017,229,18600000,170,9343000,59,9257000,Fulton County,Fulton County-Suffolk County-MA
1369,Fulton County-Pinellas County-FL-1617,"Pinellas County, FL",1617,2016,2017,250,11902000,290,18717000,-40,-6815000,Fulton County,Fulton County-Pinellas County-FL
1370,Fulton County-Fairfax County-VA-1617,"Fairfax County, VA",1617,2016,2017,294,16031000,248,14668000,46,1363000,Fulton County,Fulton County-Fairfax County-VA
1371,Fulton County-Allegheny County-PA-1617,"Allegheny County, PA",1617,2016,2017,266,10670000,119,4764000,147,5906000,Fulton County,Fulton County-Allegheny County-PA
1372,Fulton County-Charleston County-SC-1617,"Charleston County, SC",1617,2016,2017,248,10420000,279,19431000,-31,-9011000,Fulton County,Fulton County-Charleston County-SC
1373,Fulton County-Santa Clara County-CA-1617,"Santa Clara County, CA",1617,2016,2017,295,23044000,344,32780000,-49,-9736000,Fulton County,Fulton County-Santa Clara County-CA
1374,Fulton County-Richmond County-GA-1617,"Richmond County, GA",1617,2016,2017,269,7510000,152,3512000,117,3998000,Fulton County,Fulton County-Richmond County-GA
1375,Fulton County-Wayne County-MI-1617,"Wayne County, MI",1617,2016,2017,287,9076000,194,4294000,93,4782000,Fulton County,Fulton County-Wayne County-MI
1376,Fulton County-Middlesex County-MA-1617,"Middlesex County, MA",1617,2016,2017,227,13346000,213,12300000,14,1046000,Fulton County,Fulton County-Middlesex County-MA
1377,Fulton County-Franklin County-OH-1617,"Franklin County, OH",1617,2016,2017,264,11968000,191,18562000,73,-6594000,Fulton County,Fulton County-Franklin County-OH
1378,Fulton County-Orange County-CA-1617,"Orange County, CA",1617,2016,2017,304,27966000,277,19964000,27,8002000,Fulton County,Fulton County-Orange County-CA
1379,Fulton County-Montgomery County-MD-1617,"Montgomery County, MD",1617,2016,2017,245,13888000,186,9720000,59,4168000,Fulton County,Fulton County-Montgomery County-MD
1380,Fulton County-San Francisco County-CA-1617,"San Francisco County, CA",1617,2016,2017,196,18753000,251,26957000,-55,-8204000,Fulton County,Fulton County-San Francisco County-CA
1381,Fulton County-Fairfield County-CT-1617,"Fairfield County, CT",1617,2016,2017,297,26763000,103,12390000,194,14373000,Fulton County,Fulton County-Fairfield County-CT
1382,Fulton County-Oakland County-MI-1617,"Oakland County, MI",1617,2016,2017,245,14405000,162,10422000,83,3983000,Fulton County,Fulton County-Oakland County-MI
1383,Fulton County-Richland County-SC-1617,"Richland County, SC",1617,2016,2017,203,5673000,160,6886000,43,-1213000,Fulton County,Fulton County-Richland County-SC
1384,Fulton County-Greenville County-SC-1617,"Greenville County, SC",1617,2016,2017,220,11865000,187,10813000,33,1052000,Fulton County,Fulton County-Greenville County-SC
1385,Fulton County-Durham County-NC-1617,"Durham County, NC",1617,2016,2017,181,8900000,106,5088000,75,3812000,Fulton County,Fulton County-Durham County-NC
1386,Fulton County-Orleans Parish-LA-1617,"Orleans Parish, LA",1617,2016,2017,218,5661000,117,6168000,101,-507000,Fulton County,Fulton County-Orleans Parish-LA
1387,Fulton County-Hennepin County-MN-1617,"Hennepin County, MN",1617,2016,2017,232,13351000,185,16147000,47,-2796000,Fulton County,Fulton County-Hennepin County-MN
1388,Fulton County-Montgomery County-AL-1617,"Montgomery County, AL",1617,2016,2017,227,6821000,111,2344000,116,4477000,Fulton County,Fulton County-Montgomery County-AL
1389,Fulton County-Hudson County-NJ-1617,"Hudson County, NJ",1617,2016,2017,211,20310000,147,10405000,64,9905000,Fulton County,Fulton County-Hudson County-NJ
1390,Fulton County-Houston County-GA-1617,"Houston County, GA",1617,2016,2017,189,5278000,144,3743000,45,1535000,Fulton County,Fulton County-Houston County-GA
1391,Fulton County-Clark County-NV-1617,"Clark County, NV",1617,2016,2017,223,7064000,250,7715000,-27,-651000,Fulton County,Fulton County-Clark County-NV
1392,Fulton County-Arlington County-VA-1617,"Arlington County, VA",1617,2016,2017,163,11691000,111,6956000,52,4735000,Fulton County,Fulton County-Arlington County-VA
1393,Fulton County-Bronx County-NY-1617,"Bronx County, NY",1617,2016,2017,198,5013000,71,1199000,127,3814000,Fulton County,Fulton County-Bronx County-NY
1394,Fulton County-Hamilton County-OH-1617,"Hamilton County, OH",1617,2016,2017,196,9306000,135,6531000,61,2775000,Fulton County,Fulton County-Hamilton County-OH
1395,Fulton County-Tarrant County-TX-1617,"Tarrant County, TX",1617,2016,2017,233,15876000,239,16734000,-6,-858000,Fulton County,Fulton County-Tarrant County-TX
1396,Fulton County-Hamilton County-TN-1617,"Hamilton County, TN",1617,2016,2017,185,6986000,242,13415000,-57,-6429000,Fulton County,Fulton County-Hamilton County-TN
1397,Fulton County-Baltimore city-MD-1617,"Baltimore city, MD",1617,2016,2017,149,6760000,111,5602000,38,1158000,Fulton County,Fulton County-Baltimore city-MD
1398,Fulton County-Essex County-NJ-1617,"Essex County, NJ",1617,2016,2017,215,10874000,108,4071000,107,6803000,Fulton County,Fulton County-Essex County-NJ
1399,Fulton County-Denver County-CO-1617,"Denver County, CO",1617,2016,2017,149,9084000,257,18939000,-108,-9855000,Fulton County,Fulton County-Denver County-CO
1400,Fulton County-Alachua County-FL-1617,"Alachua County, FL",1617,2016,2017,144,4993000,80,2987000,64,2006000,Fulton County,Fulton County-Alachua County-FL
1401,Fulton County-Madison County-AL-1617,"Madison County, AL",1617,2016,2017,163,5194000,95,2981000,68,2213000,Fulton County,Fulton County-Madison County-AL
1402,Fulton County-Bergen County-NJ-1617,"Bergen County, NJ",1617,2016,2017,225,13819000,92,4126000,133,9693000,Fulton County,Fulton County-Bergen County-NJ
1403,Fulton County-Middlesex County-NJ-1617,"Middlesex County, NJ",1617,2016,2017,238,9884000,95,3580000,143,6304000,Fulton County,Fulton County-Middlesex County-NJ
1404,Fulton County-Westchester County-NY-1617,"Westchester County, NY",1617,2016,2017,194,16008000,95,5399000,99,10609000,Fulton County,Fulton County-Westchester County-NY
1405,Fulton County-Seminole County-FL-1617,"Seminole County, FL",1617,2016,2017,191,6991000,117,4874000,74,2117000,Fulton County,Fulton County-Seminole County-FL
1406,Fulton County-DuPage County-IL-1617,"DuPage County, IL",1617,2016,2017,241,15844000,100,7782000,141,8062000,Fulton County,Fulton County-DuPage County-IL
1407,Fulton County-Cuyahoga County-OH-1617,"Cuyahoga County, OH",1617,2016,2017,181,6347000,128,5090000,53,1257000,Fulton County,Fulton County-Cuyahoga County-OH
1408,Fulton County-Collin County-TX-1617,"Collin County, TX",1617,2016,2017,199,18753000,296,15700000,-97,3053000,Fulton County,Fulton County-Collin County-TX
1409,Fulton County-Knox County-TN-1617,"Knox County, TN",1617,2016,2017,165,6951000,136,7521000,29,-570000,Fulton County,Fulton County-Knox County-TN
1410,Fulton County-Lee County-AL-1617,"Lee County, AL",1617,2016,2017,159,3954000,80,5089000,79,-1135000,Fulton County,Fulton County-Lee County-AL
1411,Fulton County-Bexar County-TX-1617,"Bexar County, TX",1617,2016,2017,172,9637000,154,5383000,18,4254000,Fulton County,Fulton County-Bexar County-TX
1412,Fulton County-Dougherty County-GA-1617,"Dougherty County, GA",1617,2016,2017,168,3814000,41,863000,127,2951000,Fulton County,Fulton County-Dougherty County-GA
1413,Fulton County-Marion County-IN-1617,"Marion County, IN",1617,2016,2017,150,5516000,117,3979000,33,1537000,Fulton County,Fulton County-Marion County-IN
1414,Fulton County-Hartford County-CT-1617,"Hartford County, CT",1617,2016,2017,176,9603000,62,4533000,114,5070000,Fulton County,Fulton County-Hartford County-CT
1415,Fulton County-Lowndes County-GA-1617,"Lowndes County, GA",1617,2016,2017,123,3242000,55,1448000,68,1794000,Fulton County,Fulton County-Lowndes County-GA
1416,Fulton County-Guilford County-NC-1617,"Guilford County, NC",1617,2016,2017,151,5366000,112,5314000,39,52000,Fulton County,Fulton County-Guilford County-NC
1417,Fulton County-Columbia County-GA-1617,"Columbia County, GA",1617,2016,2017,162,6364000,96,2903000,66,3461000,Fulton County,Fulton County-Columbia County-GA
1418,Fulton County-Suffolk County-NY-1617,"Suffolk County, NY",1617,2016,2017,162,7434000,76,3589000,86,3845000,Fulton County,Fulton County-Suffolk County-NY
1419,Fulton County-Nassau County-NY-1617,"Nassau County, NY",1617,2016,2017,165,6219000,102,3408000,63,2811000,Fulton County,Fulton County-Nassau County-NY
1420,Fulton County-Milwaukee County-WI-1617,"Milwaukee County, WI",1617,2016,2017,149,4764000,63,2727000,86,2037000,Fulton County,Fulton County-Milwaukee County-WI
1421,Fulton County-Spalding County-GA-1617,"Spalding County, GA",1617,2016,2017,159,1747000,184,4411000,-25,-2664000,Fulton County,Fulton County-Spalding County-GA
1422,Fulton County-Bartow County-GA-1617,"Bartow County, GA",1617,2016,2017,144,5149000,179,4691000,-35,458000,Fulton County,Fulton County-Bartow County-GA
1423,Fulton County-East Baton Rouge Parish-LA-1617,"East Baton Rouge Parish, LA",1617,2016,2017,127,4251000,70,2273000,57,1978000,Fulton County,Fulton County-East Baton Rouge Parish-LA
1424,Fulton County-Jefferson County-KY-1617,"Jefferson County, KY",1617,2016,2017,135,6853000,127,6520000,8,333000,Fulton County,Fulton County-Jefferson County-KY
1425,Fulton County-Alexandria city-VA-1617,"Alexandria city, VA",1617,2016,2017,119,9599000,75,5489000,44,4110000,Fulton County,Fulton County-Alexandria city-VA
1426,Fulton County-Contra Costa County-CA-1617,"Contra Costa County, CA",1617,2016,2017,172,11979000,94,5923000,78,6056000,Fulton County,Fulton County-Contra Costa County-CA
1427,Fulton County-Lee County-FL-1617,"Lee County, FL",1617,2016,2017,131,5581000,143,8881000,-12,-3300000,Fulton County,Fulton County-Lee County-FL
1428,Fulton County-St. Louis County-MO-1617,"St. Louis County, MO",1617,2016,2017,145,6398000,132,7954000,13,-1556000,Fulton County,Fulton County-St. Louis County-MO
1429,Fulton County-Mobile County-AL-1617,"Mobile County, AL",1617,2016,2017,136,5543000,90,2960000,46,2583000,Fulton County,Fulton County-Mobile County-AL
1430,Fulton County-Bulloch County-GA-1617,"Bulloch County, GA",1617,2016,2017,102,2505000,47,894000,55,1611000,Fulton County,Fulton County-Bulloch County-GA
1431,Fulton County-Baltimore County-MD-1617,"Baltimore County, MD",1617,2016,2017,135,6776000,100,3669000,35,3107000,Fulton County,Fulton County-Baltimore County-MD
1432,Fulton County-Forsyth County-NC-1617,"Forsyth County, NC",1617,2016,2017,106,7028000,83,4018000,23,3010000,Fulton County,Fulton County-Forsyth County-NC
1433,Fulton County-Walton County-GA-1617,"Walton County, GA",1617,2016,2017,113,3568000,130,3457000,-17,111000,Fulton County,Fulton County-Walton County-GA
1434,Fulton County-Virginia Beach city-VA-1617,"Virginia Beach city, VA",1617,2016,2017,138,7771000,74,3569000,64,4202000,Fulton County,Fulton County-Virginia Beach city-VA
1435,Fulton County-Richmond city-VA-1617,"Richmond city, VA",1617,2016,2017,102,3773000,58,3030000,44,743000,Fulton County,Fulton County-Richmond city-VA
1436,Fulton County-Shelby County-AL-1617,"Shelby County, AL",1617,2016,2017,118,6414000,80,5337000,38,1077000,Fulton County,Fulton County-Shelby County-AL
1437,Fulton County-Erie County-NY-1617,"Erie County, NY",1617,2016,2017,105,3390000,58,1839000,47,1551000,Fulton County,Fulton County-Erie County-NY
1438,Fulton County-Monroe County-NY-1617,"Monroe County, NY",1617,2016,2017,114,3717000,52,1434000,62,2283000,Fulton County,Fulton County-Monroe County-NY
1439,Fulton County-Glynn County-GA-1617,"Glynn County, GA",1617,2016,2017,103,3860000,115,7730000,-12,-3870000,Fulton County,Fulton County-Glynn County-GA
1440,Fulton County-New Haven County-CT-1617,"New Haven County, CT",1617,2016,2017,115,3942000,77,3063000,38,879000,Fulton County,Fulton County-New Haven County-CT
1441,Fulton County-Denton County-TX-1617,"Denton County, TX",1617,2016,2017,128,9055000,116,5421000,12,3634000,Fulton County,Fulton County-Denton County-TX
1442,Fulton County-Jefferson Parish-LA-1617,"Jefferson Parish, LA",1617,2016,2017,99,3315000,67,2224000,32,1091000,Fulton County,Fulton County-Jefferson Parish-LA
1443,Fulton County-New Castle County-DE-1617,"New Castle County, DE",1617,2016,2017,108,3788000,42,1360000,66,2428000,Fulton County,Fulton County-New Castle County-DE
1444,Fulton County-Escambia County-FL-1617,"Escambia County, FL",1617,2016,2017,94,3731000,113,5748000,-19,-2017000,Fulton County,Fulton County-Escambia County-FL
1445,Fulton County-Jackson County-MO-1617,"Jackson County, MO",1617,2016,2017,105,4855000,61,2042000,44,2813000,Fulton County,Fulton County-Jackson County-MO
1446,Fulton County-San Bernardino County-CA-1617,"San Bernardino County, CA",1617,2016,2017,117,2900000,72,1608000,45,1292000,Fulton County,Fulton County-San Bernardino County-CA
1447,Fulton County-Beaufort County-SC-1617,"Beaufort County, SC",1617,2016,2017,91,3696000,189,17996000,-98,-14300000,Fulton County,Fulton County-Beaufort County-SC
1448,Fulton County-Henrico County-VA-1617,"Henrico County, VA",1617,2016,2017,114,4763000,77,4454000,37,309000,Fulton County,Fulton County-Henrico County-VA
1449,Fulton County-San Mateo County-CA-1617,"San Mateo County, CA",1617,2016,2017,101,16145000,77,6912000,24,9233000,Fulton County,Fulton County-San Mateo County-CA
1450,Fulton County-Troup County-GA-1617,"Troup County, GA",1617,2016,2017,110,1970000,127,2602000,-17,-632000,Fulton County,Fulton County-Troup County-GA
1451,Fulton County-Lake County-IL-1617,"Lake County, IL",1617,2016,2017,135,7518000,63,4625000,72,2893000,Fulton County,Fulton County-Lake County-IL
1452,Fulton County-Orange County-NC-1617,"Orange County, NC",1617,2016,2017,76,3890000,38,2046000,38,1844000,Fulton County,Fulton County-Orange County-NC
1453,Fulton County-Dane County-WI-1617,"Dane County, WI",1617,2016,2017,80,3776000,46,1717000,34,2059000,Fulton County,Fulton County-Dane County-WI
1454,Fulton County-Arapahoe County-CO-1617,"Arapahoe County, CO",1617,2016,2017,118,4302000,100,6083000,18,-1781000,Fulton County,Fulton County-Arapahoe County-CO
1455,Fulton County-Morris County-NJ-1617,"Morris County, NJ",1617,2016,2017,101,6598000,55,6270000,46,328000,Fulton County,Fulton County-Morris County-NJ
1456,Fulton County-Riverside County-CA-1617,"Riverside County, CA",1617,2016,2017,94,3334000,81,3433000,13,-99000,Fulton County,Fulton County-Riverside County-CA
1457,Fulton County-Washtenaw County-MI-1617,"Washtenaw County, MI",1617,2016,2017,80,3583000,56,2463000,24,1120000,Fulton County,Fulton County-Washtenaw County-MI
1458,Fulton County-Brevard County-FL-1617,"Brevard County, FL",1617,2016,2017,82,2389000,129,6103000,-47,-3714000,Fulton County,Fulton County-Brevard County-FL
1459,Fulton County-Norfolk County-MA-1617,"Norfolk County, MA",1617,2016,2017,105,6621000,80,4901000,25,1720000,Fulton County,Fulton County-Norfolk County-MA
1460,Fulton County-Buncombe County-NC-1617,"Buncombe County, NC",1617,2016,2017,72,2176000,127,5559000,-55,-3383000,Fulton County,Fulton County-Buncombe County-NC
1461,Fulton County-Multnomah County-OR-1617,"Multnomah County, OR",1617,2016,2017,75,5116000,108,5876000,-33,-760000,Fulton County,Fulton County-Multnomah County-OR
1462,Fulton County-Volusia County-FL-1617,"Volusia County, FL",1617,2016,2017,74,2126000,85,2965000,-11,-839000,Fulton County,Fulton County-Volusia County-FL
1463,Fulton County-Williamson County-TN-1617,"Williamson County, TN",1617,2016,2017,106,7138000,135,10081000,-29,-2943000,Fulton County,Fulton County-Williamson County-TN
1464,Fulton County-Montgomery County-OH-1617,"Montgomery County, OH",1617,2016,2017,95,2848000,41,1256000,54,1592000,Fulton County,Fulton County-Montgomery County-OH
1465,Fulton County-St. Johns County-FL-1617,"St. Johns County, FL",1617,2016,2017,102,7259000,127,9174000,-25,-1915000,Fulton County,Fulton County-St. Johns County-FL
1466,Fulton County-Honolulu County-HI-1617,"Honolulu County, HI",1617,2016,2017,91,2922000,64,2468000,27,454000,Fulton County,Fulton County-Honolulu County-HI
1467,Fulton County-Anne Arundel County-MD-1617,"Anne Arundel County, MD",1617,2016,2017,75,3573000,76,3545000,-1,28000,Fulton County,Fulton County-Anne Arundel County-MD
1468,Fulton County-Howard County-MD-1617,"Howard County, MD",1617,2016,2017,88,4800000,48,1772000,40,3028000,Fulton County,Fulton County-Howard County-MD
1469,Fulton County-Floyd County-GA-1617,"Floyd County, GA",1617,2016,2017,75,3383000,98,3412000,-23,-29000,Fulton County,Fulton County-Floyd County-GA
1470,Fulton County-Montgomery County-PA-1617,"Montgomery County, PA",1617,2016,2017,96,9223000,62,3993000,34,5230000,Fulton County,Fulton County-Montgomery County-PA
1471,Fulton County-Fayette County-KY-1617,"Fayette County, KY",1617,2016,2017,74,3347000,56,2482000,18,865000,Fulton County,Fulton County-Fayette County-KY
1472,Fulton County-Rutherford County-TN-1617,"Rutherford County, TN",1617,2016,2017,77,2081000,50,1242000,27,839000,Fulton County,Fulton County-Rutherford County-TN
1473,Fulton County-Somerset County-NJ-1617,"Somerset County, NJ",1617,2016,2017,98,12270000,41,3916000,57,8354000,Fulton County,Fulton County-Somerset County-NJ
1474,Fulton County-Liberty County-GA-1617,"Liberty County, GA",1617,2016,2017,101,1616000,47,659000,54,957000,Fulton County,Fulton County-Liberty County-GA
1475,Fulton County-Sarasota County-FL-1617,"Sarasota County, FL",1617,2016,2017,73,4879000,119,10176000,-46,-5297000,Fulton County,Fulton County-Sarasota County-FL
1476,Fulton County-Onondaga County-NY-1617,"Onondaga County, NY",1617,2016,2017,83,2021000,43,1729000,40,292000,Fulton County,Fulton County-Onondaga County-NY
1477,Fulton County-Fort Bend County-TX-1617,"Fort Bend County, TX",1617,2016,2017,108,5624000,66,2187000,42,3437000,Fulton County,Fulton County-Fort Bend County-TX
1478,Fulton County-Collier County-FL-1617,"Collier County, FL",1617,2016,2017,68,4248000,119,13260000,-51,-9012000,Fulton County,Fulton County-Collier County-FL
1479,Fulton County-Polk County-FL-1617,"Polk County, FL",1617,2016,2017,86,2324000,72,2082000,14,242000,Fulton County,Fulton County-Polk County-FL
1480,Fulton County-Barrow County-GA-1617,"Barrow County, GA",1617,2016,2017,66,3165000,137,3253000,-71,-88000,Fulton County,Fulton County-Barrow County-GA
1481,Fulton County-Pulaski County-AR-1617,"Pulaski County, AR",1617,2016,2017,73,2198000,65,2054000,8,144000,Fulton County,Fulton County-Pulaski County-AR
1482,Fulton County-Bay County-FL-1617,"Bay County, FL",1617,2016,2017,76,2559000,47,2657000,29,-98000,Fulton County,Fulton County-Bay County-FL
1483,Fulton County-Jackson County-GA-1617,"Jackson County, GA",1617,2016,2017,74,2261000,108,2761000,-34,-500000,Fulton County,Fulton County-Jackson County-GA
1484,Fulton County-St. Louis city-MO-1617,"St. Louis city, MO",1617,2016,2017,65,2339000,49,2019000,16,320000,Fulton County,Fulton County-St. Louis city-MO
1485,Fulton County-Cumberland County-NC-1617,"Cumberland County, NC",1617,2016,2017,72,1242000,77,1596000,-5,-354000,Fulton County,Fulton County-Cumberland County-NC
1486,Fulton County-Lexington County-SC-1617,"Lexington County, SC",1617,2016,2017,68,3045000,63,2342000,5,703000,Fulton County,Fulton County-Lexington County-SC
1487,Fulton County-Chesterfield County-VA-1617,"Chesterfield County, VA",1617,2016,2017,85,6571000,43,2190000,42,4381000,Fulton County,Fulton County-Chesterfield County-VA
1488,Fulton County-El Paso County-CO-1617,"El Paso County, CO",1617,2016,2017,84,2483000,76,2252000,8,231000,Fulton County,Fulton County-El Paso County-CO
1489,Fulton County-Spartanburg County-SC-1617,"Spartanburg County, SC",1617,2016,2017,65,2160000,41,1813000,24,347000,Fulton County,Fulton County-Spartanburg County-SC
1490,Fulton County-Salt Lake County-UT-1617,"Salt Lake County, UT",1617,2016,2017,76,2136000,106,4691000,-30,-2555000,Fulton County,Fulton County-Salt Lake County-UT
1491,Fulton County-Norfolk city-VA-1617,"Norfolk city, VA",1617,2016,2017,65,1768000,34,993000,31,775000,Fulton County,Fulton County-Norfolk city-VA
1492,Fulton County-Baldwin County-GA-1617,"Baldwin County, GA",1617,2016,2017,61,1758000,42,1293000,19,465000,Fulton County,Fulton County-Baldwin County-GA
1493,Fulton County-Dawson County-GA-1617,"Dawson County, GA",1617,2016,2017,68,2830000,174,8184000,-106,-5354000,Fulton County,Fulton County-Dawson County-GA
1494,Fulton County-Johnson County-KS-1617,"Johnson County, KS",1617,2016,2017,97,5761000,98,6900000,-1,-1139000,Fulton County,Fulton County-Johnson County-KS
1495,Fulton County-Loudoun County-VA-1617,"Loudoun County, VA",1617,2016,2017,87,6914000,115,5743000,-28,1171000,Fulton County,Fulton County-Loudoun County-VA
1496,Fulton County-Prince William County-VA-1617,"Prince William County, VA",1617,2016,2017,66,3124000,57,1757000,9,1367000,Fulton County,Fulton County-Prince William County-VA
1497,Fulton County-Okaloosa County-FL-1617,"Okaloosa County, FL",1617,2016,2017,72,2013000,60,1973000,12,40000,Fulton County,Fulton County-Okaloosa County-FL
1498,Fulton County-Pasco County-FL-1617,"Pasco County, FL",1617,2016,2017,70,2174000,73,3954000,-3,-1780000,Fulton County,Fulton County-Pasco County-FL
1499,Fulton County-Douglas County-NE-1617,"Douglas County, NE",1617,2016,2017,70,2929000,68,2393000,2,536000,Fulton County,Fulton County-Douglas County-NE
1500,Fulton County-Summit County-OH-1617,"Summit County, OH",1617,2016,2017,65,2952000,30,927000,35,2025000,Fulton County,Fulton County-Summit County-OH
1501,Fulton County-Pima County-AZ-1617,"Pima County, AZ",1617,2016,2017,61,4173000,66,3199000,-5,974000,Fulton County,Fulton County-Pima County-AZ
1502,Fulton County-Lumpkin County-GA-1617,"Lumpkin County, GA",1617,2016,2017,55,1501000,107,4532000,-52,-3031000,Fulton County,Fulton County-Lumpkin County-GA
1503,Fulton County-Oconee County-GA-1617,"Oconee County, GA",1617,2016,2017,56,3735000,112,6816000,-56,-3081000,Fulton County,Fulton County-Oconee County-GA
1504,Fulton County-Calhoun County-AL-1617,"Calhoun County, AL",1617,2016,2017,59,1738000,34,1210000,25,528000,Fulton County,Fulton County-Calhoun County-AL
1505,Fulton County-Sacramento County-CA-1617,"Sacramento County, CA",1617,2016,2017,66,2172000,85,3412000,-19,-1240000,Fulton County,Fulton County-Sacramento County-CA
1506,Fulton County-Hamilton County-IN-1617,"Hamilton County, IN",1617,2016,2017,75,3600000,68,3753000,7,-153000,Fulton County,Fulton County-Hamilton County-IN
1507,Fulton County-Pierce County-WA-1617,"Pierce County, WA",1617,2016,2017,70,1885000,61,1995000,9,-110000,Fulton County,Fulton County-Pierce County-WA
1508,Fulton County-Mercer County-NJ-1617,"Mercer County, NJ",1617,2016,2017,88,3578000,57,1960000,31,1618000,Fulton County,Fulton County-Mercer County-NJ
1509,Fulton County-New Hanover County-NC-1617,"New Hanover County, NC",1617,2016,2017,46,2378000,76,5501000,-30,-3123000,Fulton County,Fulton County-New Hanover County-NC
1510,Fulton County-Horry County-SC-1617,"Horry County, SC",1617,2016,2017,47,1706000,59,3677000,-12,-1971000,Fulton County,Fulton County-Horry County-SC
1511,Fulton County-Providence County-RI-1617,"Providence County, RI",1617,2016,2017,58,1856000,43,1924000,15,-68000,Fulton County,Fulton County-Providence County-RI
1512,Fulton County-Williamson County-TX-1617,"Williamson County, TX",1617,2016,2017,68,3108000,61,2477000,7,631000,Fulton County,Fulton County-Williamson County-TX
1513,Fulton County-Whitfield County-GA-1617,"Whitfield County, GA",1617,2016,2017,57,2303000,36,1013000,21,1290000,Fulton County,Fulton County-Whitfield County-GA
1514,Fulton County-Burlington County-NJ-1617,"Burlington County, NJ",1617,2016,2017,54,2950000,35,1832000,19,1118000,Fulton County,Fulton County-Burlington County-NJ
1515,Fulton County-Manatee County-FL-1617,"Manatee County, FL",1617,2016,2017,65,2299000,114,9478000,-49,-7179000,Fulton County,Fulton County-Manatee County-FL
1516,Fulton County-St. Lucie County-FL-1617,"St. Lucie County, FL",1617,2016,2017,57,1167000,42,2245000,15,-1078000,Fulton County,Fulton County-St. Lucie County-FL
1517,Fulton County-Meriwether County-GA-1617,"Meriwether County, GA",1617,2016,2017,56,983000,61,1037000,-5,-54000,Fulton County,Fulton County-Meriwether County-GA
1518,Fulton County-Oklahoma County-OK-1617,"Oklahoma County, OK",1617,2016,2017,51,1187000,34,938000,17,249000,Fulton County,Fulton County-Oklahoma County-OK
1519,Fulton County-Newport News city-VA-1617,"Newport News city, VA",1617,2016,2017,66,1043000,43,662000,23,381000,Fulton County,Fulton County-Newport News city-VA
1520,Fulton County-Ventura County-CA-1617,"Ventura County, CA",1617,2016,2017,70,4256000,61,3352000,9,904000,Fulton County,Fulton County-Ventura County-CA
1521,Fulton County-Kent County-MI-1617,"Kent County, MI",1617,2016,2017,69,1983000,36,1562000,33,421000,Fulton County,Fulton County-Kent County-MI
1522,Fulton County-Pickens County-GA-1617,"Pickens County, GA",1617,2016,2017,48,3771000,170,13080000,-122,-9309000,Fulton County,Fulton County-Pickens County-GA
1523,Fulton County-Washington County-OR-1617,"Washington County, OR",1617,2016,2017,54,2109000,61,3170000,-7,-1061000,Fulton County,Fulton County-Washington County-OR
1524,Fulton County-Lake County-FL-1617,"Lake County, FL",1617,2016,2017,49,1576000,51,1982000,-2,-406000,Fulton County,Fulton County-Lake County-FL
1525,Fulton County-Worcester County-MA-1617,"Worcester County, MA",1617,2016,2017,61,2882000,36,1782000,25,1100000,Fulton County,Fulton County-Worcester County-MA
1526,Fulton County-Douglas County-CO-1617,"Douglas County, CO",1617,2016,2017,73,3687000,82,4329000,-9,-642000,Fulton County,Fulton County-Douglas County-CO
1527,Fulton County-Osceola County-FL-1617,"Osceola County, FL",1617,2016,2017,54,1522000,48,2298000,6,-776000,Fulton County,Fulton County-Osceola County-FL
1528,Fulton County-Delaware County-PA-1617,"Delaware County, PA",1617,2016,2017,52,3152000,72,2825000,-20,327000,Fulton County,Fulton County-Delaware County-PA
1529,Fulton County-Berkeley County-SC-1617,"Berkeley County, SC",1617,2016,2017,42,2537000,55,3868000,-13,-1331000,Fulton County,Fulton County-Berkeley County-SC
1530,Fulton County-York County-SC-1617,"York County, SC",1617,2016,2017,54,2293000,89,3934000,-35,-1641000,Fulton County,Fulton County-York County-SC
1531,Fulton County-Tulsa County-OK-1617,"Tulsa County, OK",1617,2016,2017,54,2180000,41,1641000,13,539000,Fulton County,Fulton County-Tulsa County-OK
1532,Fulton County-Walton County-FL-1617,"Walton County, FL",1617,2016,2017,38,3818000,124,40405000,-86,-36587000,Fulton County,Fulton County-Walton County-FL
1533,Fulton County-Snohomish County-WA-1617,"Snohomish County, WA",1617,2016,2017,47,2001000,58,2918000,-11,-917000,Fulton County,Fulton County-Snohomish County-WA
1534,Fulton County-Baldwin County-AL-1617,"Baldwin County, AL",1617,2016,2017,38,1589000,44,3122000,-6,-1533000,Fulton County,Fulton County-Baldwin County-AL
1535,Fulton County-Boulder County-CO-1617,"Boulder County, CO",1617,2016,2017,38,1933000,95,5185000,-57,-3252000,Fulton County,Fulton County-Boulder County-CO
1536,Fulton County-Putnam County-GA-1617,"Putnam County, GA",1617,2016,2017,36,2072000,43,3218000,-7,-1146000,Fulton County,Fulton County-Putnam County-GA
1537,Fulton County-Bernalillo County-NM-1617,"Bernalillo County, NM",1617,2016,2017,42,1741000,61,2634000,-19,-893000,Fulton County,Fulton County-Bernalillo County-NM
1539,Gwinnett County-DeKalb County-GA-1617,"DeKalb County, GA",1617,2016,2017,15456,322417000,10247,244502000,5209,77915000,Gwinnett County,Gwinnett County-DeKalb County-GA
1540,Gwinnett County-Fulton County-GA-1617,"Fulton County, GA",1617,2016,2017,7997,241477000,7320,304663000,677,-63186000,Gwinnett County,Gwinnett County-Fulton County-GA
1541,Gwinnett County-Cobb County-GA-1617,"Cobb County, GA",1617,2016,2017,3112,79112000,2982,83621000,130,-4509000,Gwinnett County,Gwinnett County-Cobb County-GA
1542,Gwinnett County-Hall County-GA-1617,"Hall County, GA",1617,2016,2017,2080,62836000,3794,130620000,-1714,-67784000,Gwinnett County,Gwinnett County-Hall County-GA
1543,Gwinnett County-Forsyth County-GA-1617,"Forsyth County, GA",1617,2016,2017,1720,59323000,3475,130829000,-1755,-71506000,Gwinnett County,Gwinnett County-Forsyth County-GA
1544,Gwinnett County-Barrow County-GA-1617,"Barrow County, GA",1617,2016,2017,1452,31772000,3314,79689000,-1862,-47917000,Gwinnett County,Gwinnett County-Barrow County-GA
1545,Gwinnett County-Walton County-GA-1617,"Walton County, GA",1617,2016,2017,1394,30954000,3089,80238000,-1695,-49284000,Gwinnett County,Gwinnett County-Walton County-GA
1546,Gwinnett County-Clayton County-GA-1617,"Clayton County, GA",1617,2016,2017,1157,18633000,1037,14893000,120,3740000,Gwinnett County,Gwinnett County-Clayton County-GA
1547,Gwinnett County-Broward County-FL-1617,"Broward County, FL",1617,2016,2017,788,15881000,400,9212000,388,6669000,Gwinnett County,Gwinnett County-Broward County-FL
1548,Gwinnett County-Miami-Dade County-FL-1617,"Miami-Dade County, FL",1617,2016,2017,762,12674000,236,4731000,526,7943000,Gwinnett County,Gwinnett County-Miami-Dade County-FL
1549,Gwinnett County-Rockdale County-GA-1617,"Rockdale County, GA",1617,2016,2017,682,13404000,826,14316000,-144,-912000,Gwinnett County,Gwinnett County-Rockdale County-GA
1550,Gwinnett County-Los Angeles County-CA-1617,"Los Angeles County, CA",1617,2016,2017,682,13568000,441,10919000,241,2649000,Gwinnett County,Gwinnett County-Los Angeles County-CA
1551,Gwinnett County-Henry County-GA-1617,"Henry County, GA",1617,2016,2017,699,18487000,711,16574000,-12,1913000,Gwinnett County,Gwinnett County-Henry County-GA
1552,Gwinnett County-Clarke County-GA-1617,"Clarke County, GA",1617,2016,2017,543,13549000,534,13162000,9,387000,Gwinnett County,Gwinnett County-Clarke County-GA
1553,Gwinnett County-Cook County-IL-1617,"Cook County, IL",1617,2016,2017,644,14392000,316,5825000,328,8567000,Gwinnett County,Gwinnett County-Cook County-IL
1554,Gwinnett County-Queens County-NY-1617,"Queens County, NY",1617,2016,2017,617,12214000,162,2912000,455,9302000,Gwinnett County,Gwinnett County-Queens County-NY
1555,Gwinnett County-Newton County-GA-1617,"Newton County, GA",1617,2016,2017,575,11496000,681,13954000,-106,-2458000,Gwinnett County,Gwinnett County-Newton County-GA
1556,Gwinnett County-Jackson County-GA-1617,"Jackson County, GA",1617,2016,2017,577,13685000,2130,65885000,-1553,-52200000,Gwinnett County,Gwinnett County-Jackson County-GA
1557,Gwinnett County-Cherokee County-GA-1617,"Cherokee County, GA",1617,2016,2017,497,13785000,860,27673000,-363,-13888000,Gwinnett County,Gwinnett County-Cherokee County-GA
1558,Gwinnett County-Kings County-NY-1617,"Kings County, NY",1617,2016,2017,499,9183000,142,2437000,357,6746000,Gwinnett County,Gwinnett County-Kings County-NY
1559,Gwinnett County-Orange County-FL-1617,"Orange County, FL",1617,2016,2017,398,7767000,322,8363000,76,-596000,Gwinnett County,Gwinnett County-Orange County-FL
1560,Gwinnett County-Harris County-TX-1617,"Harris County, TX",1617,2016,2017,395,8433000,380,8382000,15,51000,Gwinnett County,Gwinnett County-Harris County-TX
1561,Gwinnett County-Douglas County-GA-1617,"Douglas County, GA",1617,2016,2017,399,8813000,368,7745000,31,1068000,Gwinnett County,Gwinnett County-Douglas County-GA
1562,Gwinnett County-Mecklenburg County-NC-1617,"Mecklenburg County, NC",1617,2016,2017,343,9637000,327,10600000,16,-963000,Gwinnett County,Gwinnett County-Mecklenburg County-NC
1563,Gwinnett County-Hillsborough County-FL-1617,"Hillsborough County, FL",1617,2016,2017,364,10161000,363,12335000,1,-2174000,Gwinnett County,Gwinnett County-Hillsborough County-FL
1564,Gwinnett County-Chatham County-GA-1617,"Chatham County, GA",1617,2016,2017,308,8876000,249,7511000,59,1365000,Gwinnett County,Gwinnett County-Chatham County-GA
1565,Gwinnett County-Palm Beach County-FL-1617,"Palm Beach County, FL",1617,2016,2017,328,9968000,214,6637000,114,3331000,Gwinnett County,Gwinnett County-Palm Beach County-FL
1566,Gwinnett County-Bronx County-NY-1617,"Bronx County, NY",1617,2016,2017,344,5469000,89,1175000,255,4294000,Gwinnett County,Gwinnett County-Bronx County-NY
1567,Gwinnett County-Duval County-FL-1617,"Duval County, FL",1617,2016,2017,290,7586000,309,8084000,-19,-498000,Gwinnett County,Gwinnett County-Duval County-FL
1568,Gwinnett County-Nassau County-NY-1617,"Nassau County, NY",1617,2016,2017,281,5981000,53,801000,228,5180000,Gwinnett County,Gwinnett County-Nassau County-NY
1569,Gwinnett County-Suffolk County-NY-1617,"Suffolk County, NY",1617,2016,2017,319,6055000,95,1705000,224,4350000,Gwinnett County,Gwinnett County-Suffolk County-NY
1570,Gwinnett County-Muscogee County-GA-1617,"Muscogee County, GA",1617,2016,2017,251,5017000,172,3665000,79,1352000,Gwinnett County,Gwinnett County-Muscogee County-GA
1571,Gwinnett County-Jefferson County-AL-1617,"Jefferson County, AL",1617,2016,2017,238,6167000,193,4410000,45,1757000,Gwinnett County,Gwinnett County-Jefferson County-AL
1572,Gwinnett County-Orange County-CA-1617,"Orange County, CA",1617,2016,2017,258,7267000,194,5827000,64,1440000,Gwinnett County,Gwinnett County-Orange County-CA
1573,Gwinnett County-Maricopa County-AZ-1617,"Maricopa County, AZ",1617,2016,2017,234,7740000,306,9356000,-72,-1616000,Gwinnett County,Gwinnett County-Maricopa County-AZ
1574,Gwinnett County-Richmond County-GA-1617,"Richmond County, GA",1617,2016,2017,194,3574000,109,2518000,85,1056000,Gwinnett County,Gwinnett County-Richmond County-GA
1575,Gwinnett County-Wake County-NC-1617,"Wake County, NC",1617,2016,2017,238,7878000,186,5928000,52,1950000,Gwinnett County,Gwinnett County-Wake County-NC
1576,Gwinnett County-San Diego County-CA-1617,"San Diego County, CA",1617,2016,2017,225,5943000,174,5660000,51,283000,Gwinnett County,Gwinnett County-San Diego County-CA
1577,Gwinnett County-Pinellas County-FL-1617,"Pinellas County, FL",1617,2016,2017,208,6126000,187,7530000,21,-1404000,Gwinnett County,Gwinnett County-Pinellas County-FL
1578,Gwinnett County-Shelby County-TN-1617,"Shelby County, TN",1617,2016,2017,218,4837000,178,3254000,40,1583000,Gwinnett County,Gwinnett County-Shelby County-TN
1579,Gwinnett County-New York County-NY-1617,"New York County, NY",1617,2016,2017,161,5041000,81,2663000,80,2378000,Gwinnett County,Gwinnett County-New York County-NY
1580,Gwinnett County-Essex County-NJ-1617,"Essex County, NJ",1617,2016,2017,219,3500000,83,1746000,136,1754000,Gwinnett County,Gwinnett County-Essex County-NJ
1581,Gwinnett County-Dallas County-TX-1617,"Dallas County, TX",1617,2016,2017,199,5693000,271,7267000,-72,-1574000,Gwinnett County,Gwinnett County-Dallas County-TX
1582,Gwinnett County-Bibb County-GA-1617,"Bibb County, GA",1617,2016,2017,174,4567000,110,2987000,64,1580000,Gwinnett County,Gwinnett County-Bibb County-GA
1583,Gwinnett County-Prince George's County-MD-1617,"Prince George's County, MD",1617,2016,2017,173,4239000,107,1437000,66,2802000,Gwinnett County,Gwinnett County-Prince George's County-MD
1584,Gwinnett County-Coweta County-GA-1617,"Coweta County, GA",1617,2016,2017,201,3774000,291,9080000,-90,-5306000,Gwinnett County,Gwinnett County-Coweta County-GA
1585,Gwinnett County-Fairfax County-VA-1617,"Fairfax County, VA",1617,2016,2017,215,7418000,127,4596000,88,2822000,Gwinnett County,Gwinnett County-Fairfax County-VA
1586,Gwinnett County-Paulding County-GA-1617,"Paulding County, GA",1617,2016,2017,193,4131000,326,7465000,-133,-3334000,Gwinnett County,Gwinnett County-Paulding County-GA
1587,Gwinnett County-Bergen County-NJ-1617,"Bergen County, NJ",1617,2016,2017,200,5886000,71,1722000,129,4164000,Gwinnett County,Gwinnett County-Bergen County-NJ
1588,Gwinnett County-Richland County-SC-1617,"Richland County, SC",1617,2016,2017,178,6368000,83,2190000,95,4178000,Gwinnett County,Gwinnett County-Richland County-SC
1589,Gwinnett County-Franklin County-OH-1617,"Franklin County, OH",1617,2016,2017,168,3831000,148,3224000,20,607000,Gwinnett County,Gwinnett County-Franklin County-OH
1590,Gwinnett County-Travis County-TX-1617,"Travis County, TX",1617,2016,2017,169,3486000,154,3591000,15,-105000,Gwinnett County,Gwinnett County-Travis County-TX
1591,Gwinnett County-Columbia County-GA-1617,"Columbia County, GA",1617,2016,2017,182,4659000,171,3908000,11,751000,Gwinnett County,Gwinnett County-Columbia County-GA
1592,Gwinnett County-Houston County-GA-1617,"Houston County, GA",1617,2016,2017,185,4075000,146,3035000,39,1040000,Gwinnett County,Gwinnett County-Houston County-GA
1593,Gwinnett County-Tarrant County-TX-1617,"Tarrant County, TX",1617,2016,2017,153,7558000,208,5746000,-55,1812000,Gwinnett County,Gwinnett County-Tarrant County-TX
1594,Gwinnett County-Fayette County-GA-1617,"Fayette County, GA",1617,2016,2017,161,3706000,183,6257000,-22,-2551000,Gwinnett County,Gwinnett County-Fayette County-GA
1595,Gwinnett County-Greenville County-SC-1617,"Greenville County, SC",1617,2016,2017,184,3330000,218,7552000,-34,-4222000,Gwinnett County,Gwinnett County-Greenville County-SC
1596,Gwinnett County-Hamilton County-TN-1617,"Hamilton County, TN",1617,2016,2017,163,5339000,180,5810000,-17,-471000,Gwinnett County,Gwinnett County-Hamilton County-TN
1597,Gwinnett County-Wayne County-MI-1617,"Wayne County, MI",1617,2016,2017,165,3250000,99,1699000,66,1551000,Gwinnett County,Gwinnett County-Wayne County-MI
1598,Gwinnett County-Clark County-NV-1617,"Clark County, NV",1617,2016,2017,153,3410000,192,4741000,-39,-1331000,Gwinnett County,Gwinnett County-Clark County-NV
1599,Gwinnett County-Philadelphia County-PA-1617,"Philadelphia County, PA",1617,2016,2017,159,2213000,80,1442000,79,771000,Gwinnett County,Gwinnett County-Philadelphia County-PA
1600,Gwinnett County-Carroll County-GA-1617,"Carroll County, GA",1617,2016,2017,141,2951000,140,3090000,1,-139000,Gwinnett County,Gwinnett County-Carroll County-GA
1601,Gwinnett County-Middlesex County-NJ-1617,"Middlesex County, NJ",1617,2016,2017,174,4986000,49,1681000,125,3305000,Gwinnett County,Gwinnett County-Middlesex County-NJ
1602,Gwinnett County-Cuyahoga County-OH-1617,"Cuyahoga County, OH",1617,2016,2017,132,5821000,75,1207000,57,4614000,Gwinnett County,Gwinnett County-Cuyahoga County-OH
1603,Gwinnett County-Davidson County-TN-1617,"Davidson County, TN",1617,2016,2017,129,3862000,186,4961000,-57,-1099000,Gwinnett County,Gwinnett County-Davidson County-TN
1604,Gwinnett County-Montgomery County-MD-1617,"Montgomery County, MD",1617,2016,2017,166,3802000,129,3151000,37,651000,Gwinnett County,Gwinnett County-Montgomery County-MD
1605,Gwinnett County-Montgomery County-AL-1617,"Montgomery County, AL",1617,2016,2017,142,2708000,69,1412000,73,1296000,Gwinnett County,Gwinnett County-Montgomery County-AL
1606,Gwinnett County-Charleston County-SC-1617,"Charleston County, SC",1617,2016,2017,119,2872000,117,3840000,2,-968000,Gwinnett County,Gwinnett County-Charleston County-SC
1607,Gwinnett County-Prince William County-VA-1617,"Prince William County, VA",1617,2016,2017,156,4117000,62,1373000,94,2744000,Gwinnett County,Gwinnett County-Prince William County-VA
1608,Gwinnett County-King County-WA-1617,"King County, WA",1617,2016,2017,124,4104000,190,7573000,-66,-3469000,Gwinnett County,Gwinnett County-King County-WA
1609,Gwinnett County-Lee County-FL-1617,"Lee County, FL",1617,2016,2017,144,2344000,137,5236000,7,-2892000,Gwinnett County,Gwinnett County-Lee County-FL
1610,Gwinnett County-Marion County-IN-1617,"Marion County, IN",1617,2016,2017,125,2258000,82,1558000,43,700000,Gwinnett County,Gwinnett County-Marion County-IN
1611,Gwinnett County-Oakland County-MI-1617,"Oakland County, MI",1617,2016,2017,135,3389000,76,2380000,59,1009000,Gwinnett County,Gwinnett County-Oakland County-MI
1612,Gwinnett County-Baltimore County-MD-1617,"Baltimore County, MD",1617,2016,2017,132,2847000,74,1396000,58,1451000,Gwinnett County,Gwinnett County-Baltimore County-MD
1613,Gwinnett County-Alameda County-CA-1617,"Alameda County, CA",1617,2016,2017,123,3535000,80,2937000,43,598000,Gwinnett County,Gwinnett County-Alameda County-CA
1614,Gwinnett County-St. Louis County-MO-1617,"St. Louis County, MO",1617,2016,2017,150,4140000,78,1434000,72,2706000,Gwinnett County,Gwinnett County-St. Louis County-MO
1615,Gwinnett County-Madison County-AL-1617,"Madison County, AL",1617,2016,2017,103,2929000,109,3502000,-6,-573000,Gwinnett County,Gwinnett County-Madison County-AL
1616,Gwinnett County-San Bernardino County-CA-1617,"San Bernardino County, CA",1617,2016,2017,122,1976000,82,1505000,40,471000,Gwinnett County,Gwinnett County-San Bernardino County-CA
1617,Gwinnett County-Dougherty County-GA-1617,"Dougherty County, GA",1617,2016,2017,109,2151000,79,1378000,30,773000,Gwinnett County,Gwinnett County-Dougherty County-GA
1618,Gwinnett County-Westchester County-NY-1617,"Westchester County, NY",1617,2016,2017,111,2825000,47,1174000,64,1651000,Gwinnett County,Gwinnett County-Westchester County-NY
1619,Gwinnett County-Guilford County-NC-1617,"Guilford County, NC",1617,2016,2017,109,5066000,82,2691000,27,2375000,Gwinnett County,Gwinnett County-Guilford County-NC
1620,Gwinnett County-Riverside County-CA-1617,"Riverside County, CA",1617,2016,2017,127,3521000,90,1346000,37,2175000,Gwinnett County,Gwinnett County-Riverside County-CA
1621,Gwinnett County-Santa Clara County-CA-1617,"Santa Clara County, CA",1617,2016,2017,136,4459000,103,4129000,33,330000,Gwinnett County,Gwinnett County-Santa Clara County-CA
1622,Gwinnett County-Polk County-FL-1617,"Polk County, FL",1617,2016,2017,133,2599000,125,2419000,8,180000,Gwinnett County,Gwinnett County-Polk County-FL
1623,Gwinnett County-Lee County-AL-1617,"Lee County, AL",1617,2016,2017,101,2148000,90,5460000,11,-3312000,Gwinnett County,Gwinnett County-Lee County-AL
1624,Gwinnett County-Lowndes County-GA-1617,"Lowndes County, GA",1617,2016,2017,96,2171000,73,861000,23,1310000,Gwinnett County,Gwinnett County-Lowndes County-GA
1625,Gwinnett County-DuPage County-IL-1617,"DuPage County, IL",1617,2016,2017,125,4212000,49,1372000,76,2840000,Gwinnett County,Gwinnett County-DuPage County-IL
1626,Gwinnett County-Knox County-TN-1617,"Knox County, TN",1617,2016,2017,116,4009000,97,2390000,19,1619000,Gwinnett County,Gwinnett County-Knox County-TN
1627,Gwinnett County-Seminole County-FL-1617,"Seminole County, FL",1617,2016,2017,102,2438000,157,4249000,-55,-1811000,Gwinnett County,Gwinnett County-Seminole County-FL
1628,Gwinnett County-Bartow County-GA-1617,"Bartow County, GA",1617,2016,2017,108,1957000,154,2954000,-46,-997000,Gwinnett County,Gwinnett County-Bartow County-GA
1629,Gwinnett County-Union County-NJ-1617,"Union County, NJ",1617,2016,2017,105,2606000,51,972000,54,1634000,Gwinnett County,Gwinnett County-Union County-NJ
1630,Gwinnett County-Cumberland County-NC-1617,"Cumberland County, NC",1617,2016,2017,113,2324000,69,1045000,44,1279000,Gwinnett County,Gwinnett County-Cumberland County-NC
1631,Gwinnett County-Leon County-FL-1617,"Leon County, FL",1617,2016,2017,91,2505000,82,2120000,9,385000,Gwinnett County,Gwinnett County-Leon County-FL
1632,Gwinnett County-Volusia County-FL-1617,"Volusia County, FL",1617,2016,2017,114,2424000,117,3724000,-3,-1300000,Gwinnett County,Gwinnett County-Volusia County-FL
1633,Gwinnett County-Oconee County-GA-1617,"Oconee County, GA",1617,2016,2017,97,5790000,285,11059000,-188,-5269000,Gwinnett County,Gwinnett County-Oconee County-GA
1634,Gwinnett County-Middlesex County-MA-1617,"Middlesex County, MA",1617,2016,2017,108,3640000,73,1903000,35,1737000,Gwinnett County,Gwinnett County-Middlesex County-MA
1635,Gwinnett County-Bexar County-TX-1617,"Bexar County, TX",1617,2016,2017,105,2609000,126,2977000,-21,-368000,Gwinnett County,Gwinnett County-Bexar County-TX
1636,Gwinnett County-Collin County-TX-1617,"Collin County, TX",1617,2016,2017,123,4527000,209,8903000,-86,-4376000,Gwinnett County,Gwinnett County-Collin County-TX
1637,Gwinnett County-Mobile County-AL-1617,"Mobile County, AL",1617,2016,2017,102,2052000,83,2191000,19,-139000,Gwinnett County,Gwinnett County-Mobile County-AL
1638,Gwinnett County-Osceola County-FL-1617,"Osceola County, FL",1617,2016,2017,103,1784000,75,1394000,28,390000,Gwinnett County,Gwinnett County-Osceola County-FL
1639,Gwinnett County-El Paso County-CO-1617,"El Paso County, CO",1617,2016,2017,106,1672000,97,2574000,9,-902000,Gwinnett County,Gwinnett County-El Paso County-CO
1640,Gwinnett County-Erie County-NY-1617,"Erie County, NY",1617,2016,2017,101,2159000,72,1337000,29,822000,Gwinnett County,Gwinnett County-Erie County-NY
1641,Gwinnett County-Escambia County-FL-1617,"Escambia County, FL",1617,2016,2017,102,1670000,76,1926000,26,-256000,Gwinnett County,Gwinnett County-Escambia County-FL
1642,Gwinnett County-Brevard County-FL-1617,"Brevard County, FL",1617,2016,2017,96,2944000,142,6189000,-46,-3245000,Gwinnett County,Gwinnett County-Brevard County-FL
1643,Gwinnett County-Virginia Beach city-VA-1617,"Virginia Beach city, VA",1617,2016,2017,113,2662000,80,1765000,33,897000,Gwinnett County,Gwinnett County-Virginia Beach city-VA
1644,Gwinnett County-Hartford County-CT-1617,"Hartford County, CT",1617,2016,2017,99,2432000,40,516000,59,1916000,Gwinnett County,Gwinnett County-Hartford County-CT
1645,Gwinnett County-Allegheny County-PA-1617,"Allegheny County, PA",1617,2016,2017,75,1829000,79,1908000,-4,-79000,Gwinnett County,Gwinnett County-Allegheny County-PA
1646,Gwinnett County-Pasco County-FL-1617,"Pasco County, FL",1617,2016,2017,99,2212000,107,2777000,-8,-565000,Gwinnett County,Gwinnett County-Pasco County-FL
1647,Gwinnett County-Onslow County-NC-1617,"Onslow County, NC",1617,2016,2017,78,1374000,52,708000,26,666000,Gwinnett County,Gwinnett County-Onslow County-NC
1648,Gwinnett County-St. Lucie County-FL-1617,"St. Lucie County, FL",1617,2016,2017,87,1439000,69,3243000,18,-1804000,Gwinnett County,Gwinnett County-St. Lucie County-FL
1649,Gwinnett County-Bulloch County-GA-1617,"Bulloch County, GA",1617,2016,2017,68,1300000,51,1500000,17,-200000,Gwinnett County,Gwinnett County-Bulloch County-GA
1650,Gwinnett County-Jefferson County-KY-1617,"Jefferson County, KY",1617,2016,2017,83,2085000,67,2717000,16,-632000,Gwinnett County,Gwinnett County-Jefferson County-KY
1651,Gwinnett County-Anne Arundel County-MD-1617,"Anne Arundel County, MD",1617,2016,2017,92,2393000,80,1602000,12,791000,Gwinnett County,Gwinnett County-Anne Arundel County-MD
1652,Gwinnett County-Hamilton County-OH-1617,"Hamilton County, OH",1617,2016,2017,90,2488000,95,2622000,-5,-134000,Gwinnett County,Gwinnett County-Hamilton County-OH
1653,Gwinnett County-Arapahoe County-CO-1617,"Arapahoe County, CO",1617,2016,2017,82,2326000,77,2623000,5,-297000,Gwinnett County,Gwinnett County-Arapahoe County-CO
1654,Gwinnett County-Montgomery County-OH-1617,"Montgomery County, OH",1617,2016,2017,79,1481000,30,1301000,49,180000,Gwinnett County,Gwinnett County-Montgomery County-OH
1655,Gwinnett County-Alachua County-FL-1617,"Alachua County, FL",1617,2016,2017,74,1580000,69,2072000,5,-492000,Gwinnett County,Gwinnett County-Alachua County-FL
1656,Gwinnett County-District of Columbia-DC-1617,"District of Columbia, DC",1617,2016,2017,53,2158000,49,1665000,4,493000,Gwinnett County,Gwinnett County-District of Columbia-DC
1657,Gwinnett County-Honolulu County-HI-1617,"Honolulu County, HI",1617,2016,2017,90,1690000,54,1357000,36,333000,Gwinnett County,Gwinnett County-Honolulu County-HI
1658,Gwinnett County-Denton County-TX-1617,"Denton County, TX",1617,2016,2017,79,2649000,163,8967000,-84,-6318000,Gwinnett County,Gwinnett County-Denton County-TX
1659,Gwinnett County-Milwaukee County-WI-1617,"Milwaukee County, WI",1617,2016,2017,71,1510000,70,1020000,1,490000,Gwinnett County,Gwinnett County-Milwaukee County-WI
1660,Gwinnett County-New Castle County-DE-1617,"New Castle County, DE",1617,2016,2017,76,2025000,59,1473000,17,552000,Gwinnett County,Gwinnett County-New Castle County-DE
1661,Gwinnett County-El Paso County-TX-1617,"El Paso County, TX",1617,2016,2017,92,1594000,49,809000,43,785000,Gwinnett County,Gwinnett County-El Paso County-TX
1662,Gwinnett County-Denver County-CO-1617,"Denver County, CO",1617,2016,2017,52,1113000,62,2299000,-10,-1186000,Gwinnett County,Gwinnett County-Denver County-CO
1663,Gwinnett County-Jackson County-MO-1617,"Jackson County, MO",1617,2016,2017,70,1628000,58,1126000,12,502000,Gwinnett County,Gwinnett County-Jackson County-MO
1664,Gwinnett County-Pierce County-WA-1617,"Pierce County, WA",1617,2016,2017,79,1755000,50,1078000,29,677000,Gwinnett County,Gwinnett County-Pierce County-WA
1665,Gwinnett County-Sacramento County-CA-1617,"Sacramento County, CA",1617,2016,2017,68,1157000,47,851000,21,306000,Gwinnett County,Gwinnett County-Sacramento County-CA
1666,Gwinnett County-Jefferson Parish-LA-1617,"Jefferson Parish, LA",1617,2016,2017,64,917000,67,1142000,-3,-225000,Gwinnett County,Gwinnett County-Jefferson Parish-LA
1667,Gwinnett County-Hennepin County-MN-1617,"Hennepin County, MN",1617,2016,2017,84,2225000,63,1578000,21,647000,Gwinnett County,Gwinnett County-Hennepin County-MN
1668,Gwinnett County-Montgomery County-PA-1617,"Montgomery County, PA",1617,2016,2017,89,2524000,38,890000,51,1634000,Gwinnett County,Gwinnett County-Montgomery County-PA
1669,Gwinnett County-Horry County-SC-1617,"Horry County, SC",1617,2016,2017,52,1229000,79,1995000,-27,-766000,Gwinnett County,Gwinnett County-Horry County-SC
1670,Gwinnett County-Glynn County-GA-1617,"Glynn County, GA",1617,2016,2017,61,1734000,86,3646000,-25,-1912000,Gwinnett County,Gwinnett County-Glynn County-GA
1671,Gwinnett County-Spalding County-GA-1617,"Spalding County, GA",1617,2016,2017,68,1359000,77,1474000,-9,-115000,Gwinnett County,Gwinnett County-Spalding County-GA
1672,Gwinnett County-Baltimore city-MD-1617,"Baltimore city, MD",1617,2016,2017,70,1142000,36,483000,34,659000,Gwinnett County,Gwinnett County-Baltimore city-MD
1673,Gwinnett County-Durham County-NC-1617,"Durham County, NC",1617,2016,2017,65,1710000,62,1278000,3,432000,Gwinnett County,Gwinnett County-Durham County-NC
1674,Gwinnett County-Chesterfield County-VA-1617,"Chesterfield County, VA",1617,2016,2017,58,1592000,52,1593000,6,-1000,Gwinnett County,Gwinnett County-Chesterfield County-VA
1675,Gwinnett County-Marion County-FL-1617,"Marion County, FL",1617,2016,2017,56,1636000,67,1722000,-11,-86000,Gwinnett County,Gwinnett County-Marion County-FL
1676,Gwinnett County-Sarasota County-FL-1617,"Sarasota County, FL",1617,2016,2017,56,2140000,82,2391000,-26,-251000,Gwinnett County,Gwinnett County-Sarasota County-FL
1677,Gwinnett County-Beaufort County-SC-1617,"Beaufort County, SC",1617,2016,2017,60,1538000,110,4169000,-50,-2631000,Gwinnett County,Gwinnett County-Beaufort County-SC
1678,Gwinnett County-Lexington County-SC-1617,"Lexington County, SC",1617,2016,2017,85,2209000,47,1400000,38,809000,Gwinnett County,Gwinnett County-Lexington County-SC
1679,Gwinnett County-Rutherford County-TN-1617,"Rutherford County, TN",1617,2016,2017,70,2353000,74,2211000,-4,142000,Gwinnett County,Gwinnett County-Rutherford County-TN
1680,Gwinnett County-Manatee County-FL-1617,"Manatee County, FL",1617,2016,2017,63,1766000,115,4844000,-52,-3078000,Gwinnett County,Gwinnett County-Manatee County-FL
1681,Gwinnett County-Macomb County-MI-1617,"Macomb County, MI",1617,2016,2017,61,1772000,57,1228000,4,544000,Gwinnett County,Gwinnett County-Macomb County-MI
1682,Gwinnett County-Forsyth County-NC-1617,"Forsyth County, NC",1617,2016,2017,57,1693000,57,802000,0,891000,Gwinnett County,Gwinnett County-Forsyth County-NC
1683,Gwinnett County-Dawson County-GA-1617,"Dawson County, GA",1617,2016,2017,48,1105000,191,5616000,-143,-4511000,Gwinnett County,Gwinnett County-Dawson County-GA
1684,Gwinnett County-Howard County-MD-1617,"Howard County, MD",1617,2016,2017,58,1897000,65,1614000,-7,283000,Gwinnett County,Gwinnett County-Howard County-MD
1685,Gwinnett County-Aiken County-SC-1617,"Aiken County, SC",1617,2016,2017,57,1287000,48,1529000,9,-242000,Gwinnett County,Gwinnett County-Aiken County-SC
1686,Gwinnett County-Bay County-FL-1617,"Bay County, FL",1617,2016,2017,53,1144000,83,2829000,-30,-1685000,Gwinnett County,Gwinnett County-Bay County-FL
1687,Gwinnett County-Montgomery County-TN-1617,"Montgomery County, TN",1617,2016,2017,60,1020000,61,795000,-1,225000,Gwinnett County,Gwinnett County-Montgomery County-TN
1688,Gwinnett County-Contra Costa County-CA-1617,"Contra Costa County, CA",1617,2016,2017,58,2230000,62,2264000,-4,-34000,Gwinnett County,Gwinnett County-Contra Costa County-CA
1689,Gwinnett County-Collier County-FL-1617,"Collier County, FL",1617,2016,2017,51,1478000,47,1969000,4,-491000,Gwinnett County,Gwinnett County-Collier County-FL
1690,Gwinnett County-Habersham County-GA-1617,"Habersham County, GA",1617,2016,2017,58,1148000,160,5930000,-102,-4782000,Gwinnett County,Gwinnett County-Habersham County-GA
1691,Gwinnett County-Snohomish County-WA-1617,"Snohomish County, WA",1617,2016,2017,85,2251000,49,1444000,36,807000,Gwinnett County,Gwinnett County-Snohomish County-WA
1692,Gwinnett County-Floyd County-GA-1617,"Floyd County, GA",1617,2016,2017,56,1397000,84,1534000,-28,-137000,Gwinnett County,Gwinnett County-Floyd County-GA
1693,Gwinnett County-Lumpkin County-GA-1617,"Lumpkin County, GA",1617,2016,2017,41,1089000,161,5249000,-120,-4160000,Gwinnett County,Gwinnett County-Lumpkin County-GA
1694,Gwinnett County-Troup County-GA-1617,"Troup County, GA",1617,2016,2017,53,705000,84,1813000,-31,-1108000,Gwinnett County,Gwinnett County-Troup County-GA
1695,Gwinnett County-Kent County-MI-1617,"Kent County, MI",1617,2016,2017,61,1060000,72,1255000,-11,-195000,Gwinnett County,Gwinnett County-Kent County-MI
1696,Gwinnett County-Okaloosa County-FL-1617,"Okaloosa County, FL",1617,2016,2017,57,1245000,58,2031000,-1,-786000,Gwinnett County,Gwinnett County-Okaloosa County-FL
1697,Gwinnett County-White County-GA-1617,"White County, GA",1617,2016,2017,47,1413000,154,5963000,-107,-4550000,Gwinnett County,Gwinnett County-White County-GA
1698,Gwinnett County-Orleans Parish-LA-1617,"Orleans Parish, LA",1617,2016,2017,42,737000,51,784000,-9,-47000,Gwinnett County,Gwinnett County-Orleans Parish-LA
1699,Gwinnett County-Spartanburg County-SC-1617,"Spartanburg County, SC",1617,2016,2017,56,959000,75,2104000,-19,-1145000,Gwinnett County,Gwinnett County-Spartanburg County-SC
1700,Gwinnett County-York County-SC-1617,"York County, SC",1617,2016,2017,51,1530000,62,2528000,-11,-998000,Gwinnett County,Gwinnett County-York County-SC
1701,Gwinnett County-Fort Bend County-TX-1617,"Fort Bend County, TX",1617,2016,2017,53,1711000,78,1816000,-25,-105000,Gwinnett County,Gwinnett County-Fort Bend County-TX
1702,Gwinnett County-Salt Lake County-UT-1617,"Salt Lake County, UT",1617,2016,2017,67,1658000,55,1464000,12,194000,Gwinnett County,Gwinnett County-Salt Lake County-UT
1703,Gwinnett County-Clay County-FL-1617,"Clay County, FL",1617,2016,2017,56,1194000,74,1719000,-18,-525000,Gwinnett County,Gwinnett County-Clay County-FL
1704,Gwinnett County-Berkeley County-SC-1617,"Berkeley County, SC",1617,2016,2017,49,1312000,75,2835000,-26,-1523000,Gwinnett County,Gwinnett County-Berkeley County-SC
1705,Gwinnett County-Lake County-FL-1617,"Lake County, FL",1617,2016,2017,50,999000,68,3103000,-18,-2104000,Gwinnett County,Gwinnett County-Lake County-FL
1706,Gwinnett County-Hart County-GA-1617,"Hart County, GA",1617,2016,2017,43,1260000,115,4575000,-72,-3315000,Gwinnett County,Gwinnett County-Hart County-GA
1707,Gwinnett County-Anderson County-SC-1617,"Anderson County, SC",1617,2016,2017,46,1134000,93,4583000,-47,-3449000,Gwinnett County,Gwinnett County-Anderson County-SC
1708,Gwinnett County-Pima County-AZ-1617,"Pima County, AZ",1617,2016,2017,52,1427000,92,3078000,-40,-1651000,Gwinnett County,Gwinnett County-Pima County-AZ
1709,Gwinnett County-St. Johns County-FL-1617,"St. Johns County, FL",1617,2016,2017,44,2145000,102,3545000,-58,-1400000,Gwinnett County,Gwinnett County-St. Johns County-FL
1710,Gwinnett County-Stephens County-GA-1617,"Stephens County, GA",1617,2016,2017,35,686000,79,2130000,-44,-1444000,Gwinnett County,Gwinnett County-Stephens County-GA
1711,Gwinnett County-Dorchester County-SC-1617,"Dorchester County, SC",1617,2016,2017,59,1091000,57,1580000,2,-489000,Gwinnett County,Gwinnett County-Dorchester County-SC
1712,Gwinnett County-Shelby County-AL-1617,"Shelby County, AL",1617,2016,2017,36,1128000,85,2880000,-49,-1752000,Gwinnett County,Gwinnett County-Shelby County-AL
1713,Gwinnett County-Greene County-GA-1617,"Greene County, GA",1617,2016,2017,28,1238000,113,6825000,-85,-5587000,Gwinnett County,Gwinnett County-Greene County-GA
1714,Gwinnett County-Buncombe County-NC-1617,"Buncombe County, NC",1617,2016,2017,32,626000,50,1514000,-18,-888000,Gwinnett County,Gwinnett County-Buncombe County-NC
1715,Gwinnett County-Loudoun County-VA-1617,"Loudoun County, VA",1617,2016,2017,51,2506000,71,2032000,-20,474000,Gwinnett County,Gwinnett County-Loudoun County-VA
1717,Henry County-Clayton County-GA-1617,"Clayton County, GA",1617,2016,2017,5981,103103000,3125,46308000,2856,56795000,Henry County,Henry County-Clayton County-GA
1718,Henry County-DeKalb County-GA-1617,"DeKalb County, GA",1617,2016,2017,2155,46444000,1249,26660000,906,19784000,Henry County,Henry County-DeKalb County-GA
1719,Henry County-Fulton County-GA-1617,"Fulton County, GA",1617,2016,2017,1641,35001000,1452,39618000,189,-4617000,Henry County,Henry County-Fulton County-GA
1720,Henry County-Gwinnett County-GA-1617,"Gwinnett County, GA",1617,2016,2017,711,16574000,699,18487000,12,-1913000,Henry County,Henry County-Gwinnett County-GA
1721,Henry County-Spalding County-GA-1617,"Spalding County, GA",1617,2016,2017,734,12028000,1013,20071000,-279,-8043000,Henry County,Henry County-Spalding County-GA
1722,Henry County-Cobb County-GA-1617,"Cobb County, GA",1617,2016,2017,542,13020000,634,18556000,-92,-5536000,Henry County,Henry County-Cobb County-GA
1723,Henry County-Newton County-GA-1617,"Newton County, GA",1617,2016,2017,581,11882000,444,9337000,137,2545000,Henry County,Henry County-Newton County-GA
1724,Henry County-Rockdale County-GA-1617,"Rockdale County, GA",1617,2016,2017,474,10691000,460,9871000,14,820000,Henry County,Henry County-Rockdale County-GA
1725,Henry County-Butts County-GA-1617,"Butts County, GA",1617,2016,2017,418,8334000,725,18351000,-307,-10017000,Henry County,Henry County-Butts County-GA
1726,Henry County-Fayette County-GA-1617,"Fayette County, GA",1617,2016,2017,354,9131000,495,14158000,-141,-5027000,Henry County,Henry County-Fayette County-GA
1727,Henry County-Bibb County-GA-1617,"Bibb County, GA",1617,2016,2017,228,4784000,172,3339000,56,1445000,Henry County,Henry County-Bibb County-GA
1728,Henry County-Douglas County-GA-1617,"Douglas County, GA",1617,2016,2017,227,4368000,170,3806000,57,562000,Henry County,Henry County-Douglas County-GA
1729,Henry County-Miami-Dade County-FL-1617,"Miami-Dade County, FL",1617,2016,2017,227,3420000,45,1437000,182,1983000,Henry County,Henry County-Miami-Dade County-FL
1730,Henry County-Coweta County-GA-1617,"Coweta County, GA",1617,2016,2017,174,4542000,502,16998000,-328,-12456000,Henry County,Henry County-Coweta County-GA
1731,Henry County-Broward County-FL-1617,"Broward County, FL",1617,2016,2017,190,4122000,98,1905000,92,2217000,Henry County,Henry County-Broward County-FL
1732,Henry County-Kings County-NY-1617,"Kings County, NY",1617,2016,2017,167,3314000,43,1055000,124,2259000,Henry County,Henry County-Kings County-NY
1733,Henry County-Chatham County-GA-1617,"Chatham County, GA",1617,2016,2017,143,3628000,89,2119000,54,1509000,Henry County,Henry County-Chatham County-GA
1734,Henry County-Houston County-GA-1617,"Houston County, GA",1617,2016,2017,152,3815000,119,2570000,33,1245000,Henry County,Henry County-Houston County-GA
1735,Henry County-Cook County-IL-1617,"Cook County, IL",1617,2016,2017,128,3273000,42,617000,86,2656000,Henry County,Henry County-Cook County-IL
1736,Henry County-Orange County-FL-1617,"Orange County, FL",1617,2016,2017,137,2185000,97,1778000,40,407000,Henry County,Henry County-Orange County-FL
1737,Henry County-Muscogee County-GA-1617,"Muscogee County, GA",1617,2016,2017,112,2169000,56,769000,56,1400000,Henry County,Henry County-Muscogee County-GA
1738,Henry County-Los Angeles County-CA-1617,"Los Angeles County, CA",1617,2016,2017,105,3115000,69,2091000,36,1024000,Henry County,Henry County-Los Angeles County-CA
1739,Henry County-Duval County-FL-1617,"Duval County, FL",1617,2016,2017,112,2311000,99,2177000,13,134000,Henry County,Henry County-Duval County-FL
1740,Henry County-Dougherty County-GA-1617,"Dougherty County, GA",1617,2016,2017,96,1616000,43,613000,53,1003000,Henry County,Henry County-Dougherty County-GA
1741,Henry County-Hillsborough County-FL-1617,"Hillsborough County, FL",1617,2016,2017,93,1557000,79,1867000,14,-310000,Henry County,Henry County-Hillsborough County-FL
1742,Henry County-Monroe County-GA-1617,"Monroe County, GA",1617,2016,2017,88,1546000,212,4678000,-124,-3132000,Henry County,Henry County-Monroe County-GA
1743,Henry County-Walton County-GA-1617,"Walton County, GA",1617,2016,2017,93,1707000,131,3460000,-38,-1753000,Henry County,Henry County-Walton County-GA
1744,Henry County-Palm Beach County-FL-1617,"Palm Beach County, FL",1617,2016,2017,76,1581000,65,1956000,11,-375000,Henry County,Henry County-Palm Beach County-FL
1745,Henry County-Lamar County-GA-1617,"Lamar County, GA",1617,2016,2017,78,1769000,196,4851000,-118,-3082000,Henry County,Henry County-Lamar County-GA
1746,Henry County-Paulding County-GA-1617,"Paulding County, GA",1617,2016,2017,104,2117000,121,2631000,-17,-514000,Henry County,Henry County-Paulding County-GA
1747,Henry County-Harris County-TX-1617,"Harris County, TX",1617,2016,2017,85,1807000,51,1358000,34,449000,Henry County,Henry County-Harris County-TX
1748,Henry County-Richmond County-GA-1617,"Richmond County, GA",1617,2016,2017,69,1154000,27,605000,42,549000,Henry County,Henry County-Richmond County-GA
1749,Henry County-Carroll County-GA-1617,"Carroll County, GA",1617,2016,2017,68,962000,43,1028000,25,-66000,Henry County,Henry County-Carroll County-GA
1750,Henry County-Cherokee County-GA-1617,"Cherokee County, GA",1617,2016,2017,65,1391000,208,6324000,-143,-4933000,Henry County,Henry County-Cherokee County-GA
1751,Henry County-San Diego County-CA-1617,"San Diego County, CA",1617,2016,2017,57,1242000,48,946000,9,296000,Henry County,Henry County-San Diego County-CA
1752,Henry County-Mecklenburg County-NC-1617,"Mecklenburg County, NC",1617,2016,2017,51,1303000,54,1051000,-3,252000,Henry County,Henry County-Mecklenburg County-NC
1753,Henry County-Pike County-GA-1617,"Pike County, GA",1617,2016,2017,50,1545000,215,5798000,-165,-4253000,Henry County,Henry County-Pike County-GA
1754,Henry County-Maricopa County-AZ-1617,"Maricopa County, AZ",1617,2016,2017,49,1114000,46,951000,3,163000,Henry County,Henry County-Maricopa County-AZ
1755,Henry County-Jasper County-GA-1617,"Jasper County, GA",1617,2016,2017,49,1464000,127,3554000,-78,-2090000,Henry County,Henry County-Jasper County-GA
1756,Henry County-Jefferson County-AL-1617,"Jefferson County, AL",1617,2016,2017,37,929000,46,913000,-9,16000,Henry County,Henry County-Jefferson County-AL
1757,Henry County-Clarke County-GA-1617,"Clarke County, GA",1617,2016,2017,36,723000,58,1304000,-22,-581000,Henry County,Henry County-Clarke County-GA
1758,Henry County-Hall County-GA-1617,"Hall County, GA",1617,2016,2017,31,1550000,78,2245000,-47,-695000,Henry County,Henry County-Hall County-GA
1760,Rockdale County-DeKalb County-GA-1617,"DeKalb County, GA",1617,2016,2017,2372,38993000,1412,23940000,960,15053000,Rockdale County,Rockdale County-DeKalb County-GA
1761,Rockdale County-Newton County-GA-1617,"Newton County, GA",1617,2016,2017,1691,25162000,2244,34824000,-553,-9662000,Rockdale County,Rockdale County-Newton County-GA
1762,Rockdale County-Gwinnett County-GA-1617,"Gwinnett County, GA",1617,2016,2017,826,14316000,682,13404000,144,912000,Rockdale County,Rockdale County-Gwinnett County-GA
1763,Rockdale County-Fulton County-GA-1617,"Fulton County, GA",1617,2016,2017,478,9277000,444,11677000,34,-2400000,Rockdale County,Rockdale County-Fulton County-GA
1764,Rockdale County-Henry County-GA-1617,"Henry County, GA",1617,2016,2017,460,9871000,474,10691000,-14,-820000,Rockdale County,Rockdale County-Henry County-GA
1765,Rockdale County-Clayton County-GA-1617,"Clayton County, GA",1617,2016,2017,286,4532000,202,2559000,84,1973000,Rockdale County,Rockdale County-Clayton County-GA
1766,Rockdale County-Walton County-GA-1617,"Walton County, GA",1617,2016,2017,279,4281000,365,10280000,-86,-5999000,Rockdale County,Rockdale County-Walton County-GA
1767,Rockdale County-Cobb County-GA-1617,"Cobb County, GA",1617,2016,2017,213,3979000,206,5063000,7,-1084000,Rockdale County,Rockdale County-Cobb County-GA
1768,Rockdale County-Broward County-FL-1617,"Broward County, FL",1617,2016,2017,81,1457000,42,734000,39,723000,Rockdale County,Rockdale County-Broward County-FL
1769,Rockdale County-Clarke County-GA-1617,"Clarke County, GA",1617,2016,2017,53,940000,66,1273000,-13,-333000,Rockdale County,Rockdale County-Clarke County-GA
1770,Rockdale County-Douglas County-GA-1617,"Douglas County, GA",1617,2016,2017,50,807000,41,878000,9,-71000,Rockdale County,Rockdale County-Douglas County-GA
1772,Cherokee County-Cobb County-GA-1718,"Cobb County, GA",1718,2017,2018,4922,162785000,3074,101314000,1848,61471000,Cherokee County,Cherokee County-Cobb County-GA
1773,Cherokee County-Fulton County-GA-1718,"Fulton County, GA",1718,2017,2018,2496,111313000,1336,56432000,1160,54881000,Cherokee County,Cherokee County-Fulton County-GA
1774,Cherokee County-Forsyth County-GA-1718,"Forsyth County, GA",1718,2017,2018,871,38178000,586,19402000,285,18776000,Cherokee County,Cherokee County-Forsyth County-GA
1775,Cherokee County-Gwinnett County-GA-1718,"Gwinnett County, GA",1718,2017,2018,709,24520000,397,10440000,312,14080000,Cherokee County,Cherokee County-Gwinnett County-GA
1776,Cherokee County-Pickens County-GA-1718,"Pickens County, GA",1718,2017,2018,528,14480000,636,15792000,-108,-1312000,Cherokee County,Cherokee County-Pickens County-GA
1777,Cherokee County-DeKalb County-GA-1718,"DeKalb County, GA",1718,2017,2018,408,13647000,317,10897000,91,2750000,Cherokee County,Cherokee County-DeKalb County-GA
1778,Cherokee County-Bartow County-GA-1718,"Bartow County, GA",1718,2017,2018,457,12237000,908,17692000,-451,-5455000,Cherokee County,Cherokee County-Bartow County-GA
1779,Cherokee County-Paulding County-GA-1718,"Paulding County, GA",1718,2017,2018,420,11207000,645,16329000,-225,-5122000,Cherokee County,Cherokee County-Paulding County-GA
1780,Cherokee County-Gilmer County-GA-1718,"Gilmer County, GA",1718,2017,2018,153,3277000,149,4488000,4,-1211000,Cherokee County,Cherokee County-Gilmer County-GA
1781,Cherokee County-Broward County-FL-1718,"Broward County, FL",1718,2017,2018,143,4827000,54,1987000,89,2840000,Cherokee County,Cherokee County-Broward County-FL
1782,Cherokee County-Henry County-GA-1718,"Henry County, GA",1718,2017,2018,130,4625000,54,1178000,76,3447000,Cherokee County,Cherokee County-Henry County-GA
1783,Cherokee County-Hall County-GA-1718,"Hall County, GA",1718,2017,2018,97,4183000,72,3987000,25,196000,Cherokee County,Cherokee County-Hall County-GA
1784,Cherokee County-Douglas County-GA-1718,"Douglas County, GA",1718,2017,2018,96,3002000,95,2079000,1,923000,Cherokee County,Cherokee County-Douglas County-GA
1785,Cherokee County-Palm Beach County-FL-1718,"Palm Beach County, FL",1718,2017,2018,92,2758000,47,1553000,45,1205000,Cherokee County,Cherokee County-Palm Beach County-FL
1786,Cherokee County-Clayton County-GA-1718,"Clayton County, GA",1718,2017,2018,72,1918000,71,1212000,1,706000,Cherokee County,Cherokee County-Clayton County-GA
1787,Cherokee County-Floyd County-GA-1718,"Floyd County, GA",1718,2017,2018,73,2167000,63,1025000,10,1142000,Cherokee County,Cherokee County-Floyd County-GA
1788,Cherokee County-Coweta County-GA-1718,"Coweta County, GA",1718,2017,2018,52,1824000,54,2023000,-2,-199000,Cherokee County,Cherokee County-Coweta County-GA
1789,Cherokee County-Clarke County-GA-1718,"Clarke County, GA",1718,2017,2018,45,1717000,41,1012000,4,705000,Cherokee County,Cherokee County-Clarke County-GA
1790,Cherokee County-Carroll County-GA-1718,"Carroll County, GA",1718,2017,2018,59,1755000,58,1233000,1,522000,Cherokee County,Cherokee County-Carroll County-GA
1791,Cherokee County-Duval County-FL-1718,"Duval County, FL",1718,2017,2018,56,1794000,50,2240000,6,-446000,Cherokee County,Cherokee County-Duval County-FL
1792,Cherokee County-Chatham County-GA-1718,"Chatham County, GA",1718,2017,2018,60,1193000,39,1461000,21,-268000,Cherokee County,Cherokee County-Chatham County-GA
1793,Cherokee County-Harris County-TX-1718,"Harris County, TX",1718,2017,2018,63,2162000,43,1789000,20,373000,Cherokee County,Cherokee County-Harris County-TX
1794,Cherokee County-Orange County-FL-1718,"Orange County, FL",1718,2017,2018,60,2161000,66,2231000,-6,-70000,Cherokee County,Cherokee County-Orange County-FL
1795,Cherokee County-Dawson County-GA-1718,"Dawson County, GA",1718,2017,2018,50,1411000,99,3021000,-49,-1610000,Cherokee County,Cherokee County-Dawson County-GA
1796,Cherokee County-Hillsborough County-FL-1718,"Hillsborough County, FL",1718,2017,2018,55,2094000,33,1149000,22,945000,Cherokee County,Cherokee County-Hillsborough County-FL
1797,Cherokee County-Gordon County-GA-1718,"Gordon County, GA",1718,2017,2018,56,1410000,60,1642000,-4,-232000,Cherokee County,Cherokee County-Gordon County-GA
1798,Cherokee County-Mecklenburg County-NC-1718,"Mecklenburg County, NC",1718,2017,2018,53,1547000,60,3234000,-7,-1687000,Cherokee County,Cherokee County-Mecklenburg County-NC
1799,Cherokee County-Maricopa County-AZ-1718,"Maricopa County, AZ",1718,2017,2018,55,1916000,44,1672000,11,244000,Cherokee County,Cherokee County-Maricopa County-AZ
1800,Cherokee County-Pinellas County-FL-1718,"Pinellas County, FL",1718,2017,2018,46,1182000,45,2303000,1,-1121000,Cherokee County,Cherokee County-Pinellas County-FL
1801,Cherokee County-Houston County-GA-1718,"Houston County, GA",1718,2017,2018,45,1616000,35,744000,10,872000,Cherokee County,Cherokee County-Houston County-GA
1802,Cherokee County-Fannin County-GA-1718,"Fannin County, GA",1718,2017,2018,38,900000,43,1903000,-5,-1003000,Cherokee County,Cherokee County-Fannin County-GA
1803,Cherokee County-Barrow County-GA-1718,"Barrow County, GA",1718,2017,2018,33,831000,37,710000,-4,121000,Cherokee County,Cherokee County-Barrow County-GA
1805,Clayton County-Fulton County-GA-1718,"Fulton County, GA",1718,2017,2018,7672,98687000,6372,78495000,1300,20192000,Clayton County,Clayton County-Fulton County-GA
1806,Clayton County-DeKalb County-GA-1718,"DeKalb County, GA",1718,2017,2018,3449,43790000,2726,36925000,723,6865000,Clayton County,Clayton County-DeKalb County-GA
1807,Clayton County-Henry County-GA-1718,"Henry County, GA",1718,2017,2018,2883,44961000,5003,87146000,-2120,-42185000,Clayton County,Clayton County-Henry County-GA
1808,Clayton County-Cobb County-GA-1718,"Cobb County, GA",1718,2017,2018,961,13671000,897,17443000,64,-3772000,Clayton County,Clayton County-Cobb County-GA
1809,Clayton County-Gwinnett County-GA-1718,"Gwinnett County, GA",1718,2017,2018,912,13039000,997,16013000,-85,-2974000,Clayton County,Clayton County-Gwinnett County-GA
1810,Clayton County-Fayette County-GA-1718,"Fayette County, GA",1718,2017,2018,554,15941000,968,19429000,-414,-3488000,Clayton County,Clayton County-Fayette County-GA
1811,Clayton County-Spalding County-GA-1718,"Spalding County, GA",1718,2017,2018,348,4244000,478,5722000,-130,-1478000,Clayton County,Clayton County-Spalding County-GA
1812,Clayton County-Douglas County-GA-1718,"Douglas County, GA",1718,2017,2018,319,4278000,451,6512000,-132,-2234000,Clayton County,Clayton County-Douglas County-GA
1813,Clayton County-Miami-Dade County-FL-1718,"Miami-Dade County, FL",1718,2017,2018,304,3390000,121,1818000,183,1572000,Clayton County,Clayton County-Miami-Dade County-FL
1814,Clayton County-Broward County-FL-1718,"Broward County, FL",1718,2017,2018,227,3245000,101,1541000,126,1704000,Clayton County,Clayton County-Broward County-FL
1815,Clayton County-Coweta County-GA-1718,"Coweta County, GA",1718,2017,2018,223,2749000,348,6523000,-125,-3774000,Clayton County,Clayton County-Coweta County-GA
1816,Clayton County-Rockdale County-GA-1718,"Rockdale County, GA",1718,2017,2018,223,2926000,266,4249000,-43,-1323000,Clayton County,Clayton County-Rockdale County-GA
1817,Clayton County-Chatham County-GA-1718,"Chatham County, GA",1718,2017,2018,153,2117000,98,1289000,55,828000,Clayton County,Clayton County-Chatham County-GA
1818,Clayton County-Newton County-GA-1718,"Newton County, GA",1718,2017,2018,187,2519000,253,3412000,-66,-893000,Clayton County,Clayton County-Newton County-GA
1819,Clayton County-Kings County-NY-1718,"Kings County, NY",1718,2017,2018,163,2555000,64,1182000,99,1373000,Clayton County,Clayton County-Kings County-NY
1820,Clayton County-Muscogee County-GA-1718,"Muscogee County, GA",1718,2017,2018,140,1649000,124,1310000,16,339000,Clayton County,Clayton County-Muscogee County-GA
1821,Clayton County-Orange County-FL-1718,"Orange County, FL",1718,2017,2018,145,1923000,59,969000,86,954000,Clayton County,Clayton County-Orange County-FL
1822,Clayton County-Cook County-IL-1718,"Cook County, IL",1718,2017,2018,137,2557000,87,1474000,50,1083000,Clayton County,Clayton County-Cook County-IL
1823,Clayton County-Bibb County-GA-1718,"Bibb County, GA",1718,2017,2018,137,2149000,136,1811000,1,338000,Clayton County,Clayton County-Bibb County-GA
1824,Clayton County-Queens County-NY-1718,"Queens County, NY",1718,2017,2018,104,1421000,48,807000,56,614000,Clayton County,Clayton County-Queens County-NY
1825,Clayton County-Hillsborough County-FL-1718,"Hillsborough County, FL",1718,2017,2018,113,1300000,71,928000,42,372000,Clayton County,Clayton County-Hillsborough County-FL
1826,Clayton County-Los Angeles County-CA-1718,"Los Angeles County, CA",1718,2017,2018,105,1268000,60,707000,45,561000,Clayton County,Clayton County-Los Angeles County-CA
1827,Clayton County-Duval County-FL-1718,"Duval County, FL",1718,2017,2018,100,1249000,96,1317000,4,-68000,Clayton County,Clayton County-Duval County-FL
1828,Clayton County-Dougherty County-GA-1718,"Dougherty County, GA",1718,2017,2018,95,973000,55,636000,40,337000,Clayton County,Clayton County-Dougherty County-GA
1829,Clayton County-Harris County-TX-1718,"Harris County, TX",1718,2017,2018,75,1387000,87,1260000,-12,127000,Clayton County,Clayton County-Harris County-TX
1830,Clayton County-Richmond County-GA-1718,"Richmond County, GA",1718,2017,2018,91,982000,69,932000,22,50000,Clayton County,Clayton County-Richmond County-GA
1831,Clayton County-Paulding County-GA-1718,"Paulding County, GA",1718,2017,2018,91,1507000,137,2113000,-46,-606000,Clayton County,Clayton County-Paulding County-GA
1832,Clayton County-Shelby County-TN-1718,"Shelby County, TN",1718,2017,2018,101,856000,64,981000,37,-125000,Clayton County,Clayton County-Shelby County-TN
1833,Clayton County-Palm Beach County-FL-1718,"Palm Beach County, FL",1718,2017,2018,86,941000,45,633000,41,308000,Clayton County,Clayton County-Palm Beach County-FL
1834,Clayton County-Mecklenburg County-NC-1718,"Mecklenburg County, NC",1718,2017,2018,70,963000,55,761000,15,202000,Clayton County,Clayton County-Mecklenburg County-NC
1835,Clayton County-Carroll County-GA-1718,"Carroll County, GA",1718,2017,2018,82,840000,56,661000,26,179000,Clayton County,Clayton County-Carroll County-GA
1836,Clayton County-Houston County-GA-1718,"Houston County, GA",1718,2017,2018,66,1060000,73,655000,-7,405000,Clayton County,Clayton County-Houston County-GA
1837,Clayton County-Wayne County-MI-1718,"Wayne County, MI",1718,2017,2018,80,856000,66,557000,14,299000,Clayton County,Clayton County-Wayne County-MI
1838,Clayton County-Montgomery County-AL-1718,"Montgomery County, AL",1718,2017,2018,76,810000,44,403000,32,407000,Clayton County,Clayton County-Montgomery County-AL
1839,Clayton County-Bronx County-NY-1718,"Bronx County, NY",1718,2017,2018,67,799000,45,523000,22,276000,Clayton County,Clayton County-Bronx County-NY
1840,Clayton County-Jefferson County-AL-1718,"Jefferson County, AL",1718,2017,2018,68,721000,41,738000,27,-17000,Clayton County,Clayton County-Jefferson County-AL
1841,Clayton County-Cherokee County-GA-1718,"Cherokee County, GA",1718,2017,2018,71,1212000,72,1918000,-1,-706000,Clayton County,Clayton County-Cherokee County-GA
1842,Clayton County-Dallas County-TX-1718,"Dallas County, TX",1718,2017,2018,60,836000,68,1246000,-8,-410000,Clayton County,Clayton County-Dallas County-TX
1843,Clayton County-San Diego County-CA-1718,"San Diego County, CA",1718,2017,2018,48,1056000,41,437000,7,619000,Clayton County,Clayton County-San Diego County-CA
1844,Clayton County-Lowndes County-GA-1718,"Lowndes County, GA",1718,2017,2018,60,566000,64,632000,-4,-66000,Clayton County,Clayton County-Lowndes County-GA
1845,Clayton County-Clark County-NV-1718,"Clark County, NV",1718,2017,2018,60,583000,75,1036000,-15,-453000,Clayton County,Clayton County-Clark County-NV
1846,Clayton County-Marion County-IN-1718,"Marion County, IN",1718,2017,2018,52,649000,49,515000,3,134000,Clayton County,Clayton County-Marion County-IN
1847,Clayton County-Franklin County-OH-1718,"Franklin County, OH",1718,2017,2018,68,620000,46,321000,22,299000,Clayton County,Clayton County-Franklin County-OH
1848,Clayton County-Tarrant County-TX-1718,"Tarrant County, TX",1718,2017,2018,39,429000,37,732000,2,-303000,Clayton County,Clayton County-Tarrant County-TX
1849,Clayton County-Cumberland County-NC-1718,"Cumberland County, NC",1718,2017,2018,43,626000,43,604000,0,22000,Clayton County,Clayton County-Cumberland County-NC
1851,Cobb County-Fulton County-GA-1718,"Fulton County, GA",1718,2017,2018,9292,388957000,8414,392148000,878,-3191000,Cobb County,Cobb County-Fulton County-GA
1852,Cobb County-DeKalb County-GA-1718,"DeKalb County, GA",1718,2017,2018,3629,134992000,2942,115242000,687,19750000,Cobb County,Cobb County-DeKalb County-GA
1853,Cobb County-Cherokee County-GA-1718,"Cherokee County, GA",1718,2017,2018,3074,101314000,4922,162785000,-1848,-61471000,Cobb County,Cobb County-Cherokee County-GA
1854,Cobb County-Gwinnett County-GA-1718,"Gwinnett County, GA",1718,2017,2018,2422,76200000,2255,99112000,167,-22912000,Cobb County,Cobb County-Gwinnett County-GA
1855,Cobb County-Paulding County-GA-1718,"Paulding County, GA",1718,2017,2018,2899,77307000,5489,136429000,-2590,-59122000,Cobb County,Cobb County-Paulding County-GA
1856,Cobb County-Douglas County-GA-1718,"Douglas County, GA",1718,2017,2018,1975,38316000,2910,48148000,-935,-9832000,Cobb County,Cobb County-Douglas County-GA
1857,Cobb County-Clayton County-GA-1718,"Clayton County, GA",1718,2017,2018,897,17443000,961,13671000,-64,3772000,Cobb County,Cobb County-Clayton County-GA
1858,Cobb County-Bartow County-GA-1718,"Bartow County, GA",1718,2017,2018,712,15675000,1275,34287000,-563,-18612000,Cobb County,Cobb County-Bartow County-GA
1859,Cobb County-Henry County-GA-1718,"Henry County, GA",1718,2017,2018,515,15493000,461,12600000,54,2893000,Cobb County,Cobb County-Henry County-GA
1860,Cobb County-Broward County-FL-1718,"Broward County, FL",1718,2017,2018,521,14195000,259,7747000,262,6448000,Cobb County,Cobb County-Broward County-FL
1861,Cobb County-Forsyth County-GA-1718,"Forsyth County, GA",1718,2017,2018,466,18088000,931,46798000,-465,-28710000,Cobb County,Cobb County-Forsyth County-GA
1862,Cobb County-Cook County-IL-1718,"Cook County, IL",1718,2017,2018,455,14532000,253,9252000,202,5280000,Cobb County,Cobb County-Cook County-IL
1863,Cobb County-Los Angeles County-CA-1718,"Los Angeles County, CA",1718,2017,2018,402,16630000,305,14140000,97,2490000,Cobb County,Cobb County-Los Angeles County-CA
1864,Cobb County-Miami-Dade County-FL-1718,"Miami-Dade County, FL",1718,2017,2018,365,9130000,192,6610000,173,2520000,Cobb County,Cobb County-Miami-Dade County-FL
1865,Cobb County-Carroll County-GA-1718,"Carroll County, GA",1718,2017,2018,301,7212000,340,7672000,-39,-460000,Cobb County,Cobb County-Carroll County-GA
1866,Cobb County-Orange County-FL-1718,"Orange County, FL",1718,2017,2018,310,7969000,250,8473000,60,-504000,Cobb County,Cobb County-Orange County-FL
1867,Cobb County-Fayette County-GA-1718,"Fayette County, GA",1718,2017,2018,267,16222000,240,10570000,27,5652000,Cobb County,Cobb County-Fayette County-GA
1868,Cobb County-Mecklenburg County-NC-1718,"Mecklenburg County, NC",1718,2017,2018,276,9861000,264,15794000,12,-5933000,Cobb County,Cobb County-Mecklenburg County-NC
1869,Cobb County-Harris County-TX-1718,"Harris County, TX",1718,2017,2018,312,11439000,271,11209000,41,230000,Cobb County,Cobb County-Harris County-TX
1870,Cobb County-Chatham County-GA-1718,"Chatham County, GA",1718,2017,2018,242,8174000,209,4895000,33,3279000,Cobb County,Cobb County-Chatham County-GA
1871,Cobb County-Duval County-FL-1718,"Duval County, FL",1718,2017,2018,238,14935000,249,8190000,-11,6745000,Cobb County,Cobb County-Duval County-FL
1872,Cobb County-Coweta County-GA-1718,"Coweta County, GA",1718,2017,2018,223,9111000,253,11197000,-30,-2086000,Cobb County,Cobb County-Coweta County-GA
1873,Cobb County-Palm Beach County-FL-1718,"Palm Beach County, FL",1718,2017,2018,243,7235000,170,9806000,73,-2571000,Cobb County,Cobb County-Palm Beach County-FL
1874,Cobb County-Hillsborough County-FL-1718,"Hillsborough County, FL",1718,2017,2018,212,5689000,292,10652000,-80,-4963000,Cobb County,Cobb County-Hillsborough County-FL
1875,Cobb County-Hall County-GA-1718,"Hall County, GA",1718,2017,2018,192,5212000,220,7081000,-28,-1869000,Cobb County,Cobb County-Hall County-GA
1876,Cobb County-Jefferson County-AL-1718,"Jefferson County, AL",1718,2017,2018,203,5504000,157,4344000,46,1160000,Cobb County,Cobb County-Jefferson County-AL
1877,Cobb County-Clarke County-GA-1718,"Clarke County, GA",1718,2017,2018,154,4504000,140,3751000,14,753000,Cobb County,Cobb County-Clarke County-GA
1878,Cobb County-Muscogee County-GA-1718,"Muscogee County, GA",1718,2017,2018,179,4099000,128,3839000,51,260000,Cobb County,Cobb County-Muscogee County-GA
1879,Cobb County-Rockdale County-GA-1718,"Rockdale County, GA",1718,2017,2018,178,4433000,128,2922000,50,1511000,Cobb County,Cobb County-Rockdale County-GA
1880,Cobb County-Maricopa County-AZ-1718,"Maricopa County, AZ",1718,2017,2018,191,7007000,237,10059000,-46,-3052000,Cobb County,Cobb County-Maricopa County-AZ
1881,Cobb County-Kings County-NY-1718,"Kings County, NY",1718,2017,2018,181,4463000,103,2557000,78,1906000,Cobb County,Cobb County-Kings County-NY
1882,Cobb County-Richmond County-GA-1718,"Richmond County, GA",1718,2017,2018,156,4091000,114,3716000,42,375000,Cobb County,Cobb County-Richmond County-GA
1883,Cobb County-Wake County-NC-1718,"Wake County, NC",1718,2017,2018,204,6798000,181,7592000,23,-794000,Cobb County,Cobb County-Wake County-NC
1884,Cobb County-Shelby County-TN-1718,"Shelby County, TN",1718,2017,2018,183,6773000,124,4154000,59,2619000,Cobb County,Cobb County-Shelby County-TN
1885,Cobb County-Dallas County-TX-1718,"Dallas County, TX",1718,2017,2018,163,5470000,212,9859000,-49,-4389000,Cobb County,Cobb County-Dallas County-TX
1886,Cobb County-Bibb County-GA-1718,"Bibb County, GA",1718,2017,2018,164,5148000,106,3833000,58,1315000,Cobb County,Cobb County-Bibb County-GA
1887,Cobb County-Queens County-NY-1718,"Queens County, NY",1718,2017,2018,174,3827000,62,1835000,112,1992000,Cobb County,Cobb County-Queens County-NY
1888,Cobb County-Floyd County-GA-1718,"Floyd County, GA",1718,2017,2018,156,4098000,154,4649000,2,-551000,Cobb County,Cobb County-Floyd County-GA
1889,Cobb County-Hamilton County-TN-1718,"Hamilton County, TN",1718,2017,2018,155,7178000,138,6536000,17,642000,Cobb County,Cobb County-Hamilton County-TN
1890,Cobb County-San Diego County-CA-1718,"San Diego County, CA",1718,2017,2018,143,5284000,164,6872000,-21,-1588000,Cobb County,Cobb County-San Diego County-CA
1891,Cobb County-New York County-NY-1718,"New York County, NY",1718,2017,2018,127,6605000,88,6579000,39,26000,Cobb County,Cobb County-New York County-NY
1892,Cobb County-Pinellas County-FL-1718,"Pinellas County, FL",1718,2017,2018,122,5543000,168,9573000,-46,-4030000,Cobb County,Cobb County-Pinellas County-FL
1893,Cobb County-Davidson County-TN-1718,"Davidson County, TN",1718,2017,2018,121,4266000,175,10169000,-54,-5903000,Cobb County,Cobb County-Davidson County-TN
1894,Cobb County-Newton County-GA-1718,"Newton County, GA",1718,2017,2018,142,3114000,149,3646000,-7,-532000,Cobb County,Cobb County-Newton County-GA
1895,Cobb County-Wayne County-MI-1718,"Wayne County, MI",1718,2017,2018,138,4591000,94,2709000,44,1882000,Cobb County,Cobb County-Wayne County-MI
1896,Cobb County-Houston County-GA-1718,"Houston County, GA",1718,2017,2018,125,4103000,93,2458000,32,1645000,Cobb County,Cobb County-Houston County-GA
1897,Cobb County-Travis County-TX-1718,"Travis County, TX",1718,2017,2018,134,4486000,141,6375000,-7,-1889000,Cobb County,Cobb County-Travis County-TX
1898,Cobb County-Montgomery County-AL-1718,"Montgomery County, AL",1718,2017,2018,126,3310000,54,1238000,72,2072000,Cobb County,Cobb County-Montgomery County-AL
1899,Cobb County-Orange County-CA-1718,"Orange County, CA",1718,2017,2018,154,5096000,104,5305000,50,-209000,Cobb County,Cobb County-Orange County-CA
1900,Cobb County-Leon County-FL-1718,"Leon County, FL",1718,2017,2018,105,4329000,45,1028000,60,3301000,Cobb County,Cobb County-Leon County-FL
1901,Cobb County-Prince George's County-MD-1718,"Prince George's County, MD",1718,2017,2018,108,3158000,59,1547000,49,1611000,Cobb County,Cobb County-Prince George's County-MD
1902,Cobb County-Fairfax County-VA-1718,"Fairfax County, VA",1718,2017,2018,126,6564000,116,5235000,10,1329000,Cobb County,Cobb County-Fairfax County-VA
1903,Cobb County-Greenville County-SC-1718,"Greenville County, SC",1718,2017,2018,99,3486000,126,6482000,-27,-2996000,Cobb County,Cobb County-Greenville County-SC
1904,Cobb County-Bronx County-NY-1718,"Bronx County, NY",1718,2017,2018,115,2388000,51,783000,64,1605000,Cobb County,Cobb County-Bronx County-NY
1905,Cobb County-Lee County-FL-1718,"Lee County, FL",1718,2017,2018,106,3473000,85,4201000,21,-728000,Cobb County,Cobb County-Lee County-FL
1906,Cobb County-Clark County-NV-1718,"Clark County, NV",1718,2017,2018,115,3565000,150,5422000,-35,-1857000,Cobb County,Cobb County-Clark County-NV
1907,Cobb County-King County-WA-1718,"King County, WA",1718,2017,2018,115,6438000,197,10278000,-82,-3840000,Cobb County,Cobb County-King County-WA
1908,Cobb County-Cuyahoga County-OH-1718,"Cuyahoga County, OH",1718,2017,2018,116,2891000,86,2540000,30,351000,Cobb County,Cobb County-Cuyahoga County-OH
1909,Cobb County-Bexar County-TX-1718,"Bexar County, TX",1718,2017,2018,117,3302000,77,1849000,40,1453000,Cobb County,Cobb County-Bexar County-TX
1910,Cobb County-Tarrant County-TX-1718,"Tarrant County, TX",1718,2017,2018,118,3834000,173,6771000,-55,-2937000,Cobb County,Cobb County-Tarrant County-TX
1911,Cobb County-Philadelphia County-PA-1718,"Philadelphia County, PA",1718,2017,2018,87,2545000,55,1458000,32,1087000,Cobb County,Cobb County-Philadelphia County-PA
1912,Cobb County-Montgomery County-MD-1718,"Montgomery County, MD",1718,2017,2018,105,3828000,75,3808000,30,20000,Cobb County,Cobb County-Montgomery County-MD
1913,Cobb County-Nassau County-NY-1718,"Nassau County, NY",1718,2017,2018,111,4385000,31,699000,80,3686000,Cobb County,Cobb County-Nassau County-NY
1914,Cobb County-Bay County-FL-1718,"Bay County, FL",1718,2017,2018,82,4066000,68,2929000,14,1137000,Cobb County,Cobb County-Bay County-FL
1915,Cobb County-Middlesex County-MA-1718,"Middlesex County, MA",1718,2017,2018,92,4976000,59,2425000,33,2551000,Cobb County,Cobb County-Middlesex County-MA
1916,Cobb County-Seminole County-FL-1718,"Seminole County, FL",1718,2017,2018,92,2433000,85,3599000,7,-1166000,Cobb County,Cobb County-Seminole County-FL
1917,Cobb County-Columbia County-GA-1718,"Columbia County, GA",1718,2017,2018,102,4103000,72,3047000,30,1056000,Cobb County,Cobb County-Columbia County-GA
1918,Cobb County-Volusia County-FL-1718,"Volusia County, FL",1718,2017,2018,103,1739000,64,3082000,39,-1343000,Cobb County,Cobb County-Volusia County-FL
1919,Cobb County-Richland County-SC-1718,"Richland County, SC",1718,2017,2018,98,3304000,94,2933000,4,371000,Cobb County,Cobb County-Richland County-SC
1920,Cobb County-Dougherty County-GA-1718,"Dougherty County, GA",1718,2017,2018,83,1804000,58,881000,25,923000,Cobb County,Cobb County-Dougherty County-GA
1921,Cobb County-Franklin County-OH-1718,"Franklin County, OH",1718,2017,2018,86,2377000,103,5851000,-17,-3474000,Cobb County,Cobb County-Franklin County-OH
1922,Cobb County-Charleston County-SC-1718,"Charleston County, SC",1718,2017,2018,79,2289000,113,6158000,-34,-3869000,Cobb County,Cobb County-Charleston County-SC
1923,Cobb County-Alameda County-CA-1718,"Alameda County, CA",1718,2017,2018,90,4259000,64,2610000,26,1649000,Cobb County,Cobb County-Alameda County-CA
1924,Cobb County-Santa Clara County-CA-1718,"Santa Clara County, CA",1718,2017,2018,90,6075000,110,5573000,-20,502000,Cobb County,Cobb County-Santa Clara County-CA
1925,Cobb County-Brevard County-FL-1718,"Brevard County, FL",1718,2017,2018,81,2153000,99,3797000,-18,-1644000,Cobb County,Cobb County-Brevard County-FL
1926,Cobb County-Riverside County-CA-1718,"Riverside County, CA",1718,2017,2018,96,3116000,72,1747000,24,1369000,Cobb County,Cobb County-Riverside County-CA
1927,Cobb County-Lowndes County-GA-1718,"Lowndes County, GA",1718,2017,2018,70,1413000,60,1713000,10,-300000,Cobb County,Cobb County-Lowndes County-GA
1928,Cobb County-Jefferson County-KY-1718,"Jefferson County, KY",1718,2017,2018,89,4153000,57,3829000,32,324000,Cobb County,Cobb County-Jefferson County-KY
1929,Cobb County-Guilford County-NC-1718,"Guilford County, NC",1718,2017,2018,82,2012000,50,1268000,32,744000,Cobb County,Cobb County-Guilford County-NC
1930,Cobb County-Mobile County-AL-1718,"Mobile County, AL",1718,2017,2018,72,1732000,40,572000,32,1160000,Cobb County,Cobb County-Mobile County-AL
1931,Cobb County-Fairfield County-CT-1718,"Fairfield County, CT",1718,2017,2018,92,4671000,58,3546000,34,1125000,Cobb County,Cobb County-Fairfield County-CT
1932,Cobb County-Marion County-IN-1718,"Marion County, IN",1718,2017,2018,93,2074000,47,1427000,46,647000,Cobb County,Cobb County-Marion County-IN
1933,Cobb County-St. Louis County-MO-1718,"St. Louis County, MO",1718,2017,2018,87,2225000,95,3452000,-8,-1227000,Cobb County,Cobb County-St. Louis County-MO
1934,Cobb County-Lee County-AL-1718,"Lee County, AL",1718,2017,2018,70,1701000,96,3941000,-26,-2240000,Cobb County,Cobb County-Lee County-AL
1935,Cobb County-Oakland County-MI-1718,"Oakland County, MI",1718,2017,2018,72,2892000,81,3060000,-9,-168000,Cobb County,Cobb County-Oakland County-MI
1936,Cobb County-DuPage County-IL-1718,"DuPage County, IL",1718,2017,2018,91,8421000,55,3699000,36,4722000,Cobb County,Cobb County-DuPage County-IL
1937,Cobb County-Middlesex County-NJ-1718,"Middlesex County, NJ",1718,2017,2018,91,3845000,52,1444000,39,2401000,Cobb County,Cobb County-Middlesex County-NJ
1938,Cobb County-Pickens County-GA-1718,"Pickens County, GA",1718,2017,2018,77,2244000,163,8361000,-86,-6117000,Cobb County,Cobb County-Pickens County-GA
1939,Cobb County-Allegheny County-PA-1718,"Allegheny County, PA",1718,2017,2018,65,3654000,82,3206000,-17,448000,Cobb County,Cobb County-Allegheny County-PA
1940,Cobb County-Knox County-TN-1718,"Knox County, TN",1718,2017,2018,72,2424000,81,3082000,-9,-658000,Cobb County,Cobb County-Knox County-TN
1941,Cobb County-Madison County-AL-1718,"Madison County, AL",1718,2017,2018,60,2117000,99,3548000,-39,-1431000,Cobb County,Cobb County-Madison County-AL
1942,Cobb County-Orleans Parish-LA-1718,"Orleans Parish, LA",1718,2017,2018,60,2269000,44,819000,16,1450000,Cobb County,Cobb County-Orleans Parish-LA
1943,Cobb County-District of Columbia-DC-1718,"District of Columbia, DC",1718,2017,2018,50,2923000,67,2688000,-17,235000,Cobb County,Cobb County-District of Columbia-DC
1944,Cobb County-Polk County-FL-1718,"Polk County, FL",1718,2017,2018,79,1292000,57,2626000,22,-1334000,Cobb County,Cobb County-Polk County-FL
1945,Cobb County-Bulloch County-GA-1718,"Bulloch County, GA",1718,2017,2018,51,1426000,38,845000,13,581000,Cobb County,Cobb County-Bulloch County-GA
1946,Cobb County-Bergen County-NJ-1718,"Bergen County, NJ",1718,2017,2018,87,3011000,40,1463000,47,1548000,Cobb County,Cobb County-Bergen County-NJ
1947,Cobb County-Baltimore County-MD-1718,"Baltimore County, MD",1718,2017,2018,74,1876000,37,1250000,37,626000,Cobb County,Cobb County-Baltimore County-MD
1948,Cobb County-Escambia County-FL-1718,"Escambia County, FL",1718,2017,2018,63,1334000,66,1636000,-3,-302000,Cobb County,Cobb County-Escambia County-FL
1949,Cobb County-Walton County-GA-1718,"Walton County, GA",1718,2017,2018,64,2131000,59,1647000,5,484000,Cobb County,Cobb County-Walton County-GA
1950,Cobb County-Hennepin County-MN-1718,"Hennepin County, MN",1718,2017,2018,64,3590000,68,2314000,-4,1276000,Cobb County,Cobb County-Hennepin County-MN
1951,Cobb County-Hamilton County-OH-1718,"Hamilton County, OH",1718,2017,2018,64,2243000,64,2127000,0,116000,Cobb County,Cobb County-Hamilton County-OH
1952,Cobb County-Collin County-TX-1718,"Collin County, TX",1718,2017,2018,65,2770000,122,7044000,-57,-4274000,Cobb County,Cobb County-Collin County-TX
1953,Cobb County-Milwaukee County-WI-1718,"Milwaukee County, WI",1718,2017,2018,70,1151000,67,1665000,3,-514000,Cobb County,Cobb County-Milwaukee County-WI
1954,Cobb County-Shelby County-AL-1718,"Shelby County, AL",1718,2017,2018,53,2774000,65,2818000,-12,-44000,Cobb County,Cobb County-Shelby County-AL
1955,Cobb County-Gordon County-GA-1718,"Gordon County, GA",1718,2017,2018,57,1152000,111,2286000,-54,-1134000,Cobb County,Cobb County-Gordon County-GA
1956,Cobb County-Sarasota County-FL-1718,"Sarasota County, FL",1718,2017,2018,59,1504000,77,6947000,-18,-5443000,Cobb County,Cobb County-Sarasota County-FL
1957,Cobb County-Whitfield County-GA-1718,"Whitfield County, GA",1718,2017,2018,59,1647000,66,2191000,-7,-544000,Cobb County,Cobb County-Whitfield County-GA
1958,Cobb County-Contra Costa County-CA-1718,"Contra Costa County, CA",1718,2017,2018,57,2251000,48,2008000,9,243000,Cobb County,Cobb County-Contra Costa County-CA
1959,Cobb County-Arapahoe County-CO-1718,"Arapahoe County, CO",1718,2017,2018,52,2011000,66,1622000,-14,389000,Cobb County,Cobb County-Arapahoe County-CO
1960,Cobb County-Barrow County-GA-1718,"Barrow County, GA",1718,2017,2018,46,1418000,70,2022000,-24,-604000,Cobb County,Cobb County-Barrow County-GA
1961,Cobb County-Polk County-GA-1718,"Polk County, GA",1718,2017,2018,55,1563000,108,2784000,-53,-1221000,Cobb County,Cobb County-Polk County-GA
1962,Cobb County-Hudson County-NJ-1718,"Hudson County, NJ",1718,2017,2018,57,2656000,36,1389000,21,1267000,Cobb County,Cobb County-Hudson County-NJ
1963,Cobb County-Monroe County-NY-1718,"Monroe County, NY",1718,2017,2018,56,1205000,40,580000,16,625000,Cobb County,Cobb County-Monroe County-NY
1964,Cobb County-Denton County-TX-1718,"Denton County, TX",1718,2017,2018,56,2423000,103,3454000,-47,-1031000,Cobb County,Cobb County-Denton County-TX
1965,Cobb County-Virginia Beach city-VA-1718,"Virginia Beach city, VA",1718,2017,2018,65,2398000,54,888000,11,1510000,Cobb County,Cobb County-Virginia Beach city-VA
1966,Cobb County-Glynn County-GA-1718,"Glynn County, GA",1718,2017,2018,51,1159000,81,3138000,-30,-1979000,Cobb County,Cobb County-Glynn County-GA
1967,Cobb County-Suffolk County-MA-1718,"Suffolk County, MA",1718,2017,2018,43,1796000,32,1541000,11,255000,Cobb County,Cobb County-Suffolk County-MA
1968,Cobb County-Beaufort County-SC-1718,"Beaufort County, SC",1718,2017,2018,43,1641000,87,7389000,-44,-5748000,Cobb County,Cobb County-Beaufort County-SC
1969,Cobb County-Rutherford County-TN-1718,"Rutherford County, TN",1718,2017,2018,59,1608000,51,2165000,8,-557000,Cobb County,Cobb County-Rutherford County-TN
1970,Cobb County-Fort Bend County-TX-1718,"Fort Bend County, TX",1718,2017,2018,68,3299000,61,1572000,7,1727000,Cobb County,Cobb County-Fort Bend County-TX
1971,Cobb County-Henrico County-VA-1718,"Henrico County, VA",1718,2017,2018,65,2479000,52,1533000,13,946000,Cobb County,Cobb County-Henrico County-VA
1972,Cobb County-Denver County-CO-1718,"Denver County, CO",1718,2017,2018,32,1227000,69,3855000,-37,-2628000,Cobb County,Cobb County-Denver County-CO
1973,Cobb County-El Paso County-CO-1718,"El Paso County, CO",1718,2017,2018,62,1547000,77,1661000,-15,-114000,Cobb County,Cobb County-El Paso County-CO
1974,Cobb County-Manatee County-FL-1718,"Manatee County, FL",1718,2017,2018,50,959000,73,3914000,-23,-2955000,Cobb County,Cobb County-Manatee County-FL
1975,Cobb County-Gilmer County-GA-1718,"Gilmer County, GA",1718,2017,2018,48,2512000,114,4389000,-66,-1877000,Cobb County,Cobb County-Gilmer County-GA
1976,Cobb County-Buncombe County-NC-1718,"Buncombe County, NC",1718,2017,2018,45,1514000,57,2468000,-12,-954000,Cobb County,Cobb County-Buncombe County-NC
1977,Cobb County-Pima County-AZ-1718,"Pima County, AZ",1718,2017,2018,32,1415000,53,1681000,-21,-266000,Cobb County,Cobb County-Pima County-AZ
1978,Cobb County-Lake County-FL-1718,"Lake County, FL",1718,2017,2018,50,1522000,36,1446000,14,76000,Cobb County,Cobb County-Lake County-FL
1979,Cobb County-St. Lucie County-FL-1718,"St. Lucie County, FL",1718,2017,2018,42,811000,46,1581000,-4,-770000,Cobb County,Cobb County-St. Lucie County-FL
1980,Cobb County-Pasco County-FL-1718,"Pasco County, FL",1718,2017,2018,53,1739000,85,3319000,-32,-1580000,Cobb County,Cobb County-Pasco County-FL
1981,Cobb County-St. Johns County-FL-1718,"St. Johns County, FL",1718,2017,2018,49,2730000,104,6223000,-55,-3493000,Cobb County,Cobb County-St. Johns County-FL
1982,Cobb County-Berkeley County-SC-1718,"Berkeley County, SC",1718,2017,2018,38,1022000,35,967000,3,55000,Cobb County,Cobb County-Berkeley County-SC
1983,Cobb County-Troup County-GA-1718,"Troup County, GA",1718,2017,2018,40,1040000,38,931000,2,109000,Cobb County,Cobb County-Troup County-GA
1984,Cobb County-Horry County-SC-1718,"Horry County, SC",1718,2017,2018,36,507000,69,2722000,-33,-2215000,Cobb County,Cobb County-Horry County-SC
1985,Cobb County-Okaloosa County-FL-1718,"Okaloosa County, FL",1718,2017,2018,45,1225000,48,3106000,-3,-1881000,Cobb County,Cobb County-Okaloosa County-FL
1986,Cobb County-Salt Lake County-UT-1718,"Salt Lake County, UT",1718,2017,2018,47,1313000,69,2795000,-22,-1482000,Cobb County,Cobb County-Salt Lake County-UT
1987,Cobb County-Sacramento County-CA-1718,"Sacramento County, CA",1718,2017,2018,48,1066000,40,873000,8,193000,Cobb County,Cobb County-Sacramento County-CA
1988,Cobb County-Norfolk County-MA-1718,"Norfolk County, MA",1718,2017,2018,37,1764000,34,1962000,3,-198000,Cobb County,Cobb County-Norfolk County-MA
1989,Cobb County-Jackson County-MO-1718,"Jackson County, MO",1718,2017,2018,35,980000,41,970000,-6,10000,Cobb County,Cobb County-Jackson County-MO
1990,Cobb County-Arlington County-VA-1718,"Arlington County, VA",1718,2017,2018,30,2327000,30,1721000,0,606000,Cobb County,Cobb County-Arlington County-VA
1991,Cobb County-San Francisco County-CA-1718,"San Francisco County, CA",1718,2017,2018,25,2041000,42,2801000,-17,-760000,Cobb County,Cobb County-San Francisco County-CA
1992,Cobb County-Haralson County-GA-1718,"Haralson County, GA",1718,2017,2018,26,714000,70,1926000,-44,-1212000,Cobb County,Cobb County-Haralson County-GA
1993,Cobb County-Oconee County-GA-1718,"Oconee County, GA",1718,2017,2018,43,1392000,51,3552000,-8,-2160000,Cobb County,Cobb County-Oconee County-GA
1995,DeKalb County-Fulton County-GA-1718,"Fulton County, GA",1718,2017,2018,14113,591527000,14050,745376000,63,-153849000,DeKalb County,DeKalb County-Fulton County-GA
1996,DeKalb County-Gwinnett County-GA-1718,"Gwinnett County, GA",1718,2017,2018,8214,196222000,12024,256430000,-3810,-60208000,DeKalb County,DeKalb County-Gwinnett County-GA
1997,DeKalb County-Cobb County-GA-1718,"Cobb County, GA",1718,2017,2018,2942,115242000,3629,134992000,-687,-19750000,DeKalb County,DeKalb County-Cobb County-GA
1998,DeKalb County-Clayton County-GA-1718,"Clayton County, GA",1718,2017,2018,2726,36925000,3449,43790000,-723,-6865000,DeKalb County,DeKalb County-Clayton County-GA
1999,DeKalb County-Rockdale County-GA-1718,"Rockdale County, GA",1718,2017,2018,1222,21355000,1934,33496000,-712,-12141000,DeKalb County,DeKalb County-Rockdale County-GA
2000,DeKalb County-Henry County-GA-1718,"Henry County, GA",1718,2017,2018,982,23640000,1798,33169000,-816,-9529000,DeKalb County,DeKalb County-Henry County-GA
2001,DeKalb County-Newton County-GA-1718,"Newton County, GA",1718,2017,2018,811,12874000,1246,20031000,-435,-7157000,DeKalb County,DeKalb County-Newton County-GA
2002,DeKalb County-Los Angeles County-CA-1718,"Los Angeles County, CA",1718,2017,2018,435,17397000,401,17181000,34,216000,DeKalb County,DeKalb County-Los Angeles County-CA
2003,DeKalb County-Cook County-IL-1718,"Cook County, IL",1718,2017,2018,420,17782000,320,12626000,100,5156000,DeKalb County,DeKalb County-Cook County-IL
2004,DeKalb County-Miami-Dade County-FL-1718,"Miami-Dade County, FL",1718,2017,2018,448,9859000,196,5181000,252,4678000,DeKalb County,DeKalb County-Miami-Dade County-FL
2005,DeKalb County-Douglas County-GA-1718,"Douglas County, GA",1718,2017,2018,402,8331000,478,9365000,-76,-1034000,DeKalb County,DeKalb County-Douglas County-GA
2006,DeKalb County-Forsyth County-GA-1718,"Forsyth County, GA",1718,2017,2018,376,12526000,868,38377000,-492,-25851000,DeKalb County,DeKalb County-Forsyth County-GA
2007,DeKalb County-Broward County-FL-1718,"Broward County, FL",1718,2017,2018,362,9844000,290,11466000,72,-1622000,DeKalb County,DeKalb County-Broward County-FL
2008,DeKalb County-Kings County-NY-1718,"Kings County, NY",1718,2017,2018,380,12351000,189,5640000,191,6711000,DeKalb County,DeKalb County-Kings County-NY
2009,DeKalb County-Clarke County-GA-1718,"Clarke County, GA",1718,2017,2018,271,8612000,197,6254000,74,2358000,DeKalb County,DeKalb County-Clarke County-GA
2010,DeKalb County-Cherokee County-GA-1718,"Cherokee County, GA",1718,2017,2018,317,10897000,408,13647000,-91,-2750000,DeKalb County,DeKalb County-Cherokee County-GA
2011,DeKalb County-Mecklenburg County-NC-1718,"Mecklenburg County, NC",1718,2017,2018,280,9390000,312,12516000,-32,-3126000,DeKalb County,DeKalb County-Mecklenburg County-NC
2012,DeKalb County-Harris County-TX-1718,"Harris County, TX",1718,2017,2018,275,8187000,290,9406000,-15,-1219000,DeKalb County,DeKalb County-Harris County-TX
2013,DeKalb County-Davidson County-TN-1718,"Davidson County, TN",1718,2017,2018,232,9227000,175,6411000,57,2816000,DeKalb County,DeKalb County-Davidson County-TN
2014,DeKalb County-Chatham County-GA-1718,"Chatham County, GA",1718,2017,2018,253,6475000,199,5594000,54,881000,DeKalb County,DeKalb County-Chatham County-GA
2015,DeKalb County-Fayette County-GA-1718,"Fayette County, GA",1718,2017,2018,231,9673000,246,7402000,-15,2271000,DeKalb County,DeKalb County-Fayette County-GA
2016,DeKalb County-Hillsborough County-FL-1718,"Hillsborough County, FL",1718,2017,2018,229,7267000,197,6377000,32,890000,DeKalb County,DeKalb County-Hillsborough County-FL
2017,DeKalb County-Duval County-FL-1718,"Duval County, FL",1718,2017,2018,242,4755000,218,5484000,24,-729000,DeKalb County,DeKalb County-Duval County-FL
2018,DeKalb County-Dallas County-TX-1718,"Dallas County, TX",1718,2017,2018,243,11244000,249,9954000,-6,1290000,DeKalb County,DeKalb County-Dallas County-TX
2019,DeKalb County-Orange County-FL-1718,"Orange County, FL",1718,2017,2018,249,6817000,240,7291000,9,-474000,DeKalb County,DeKalb County-Orange County-FL
2020,DeKalb County-Hall County-GA-1718,"Hall County, GA",1718,2017,2018,234,6462000,293,7656000,-59,-1194000,DeKalb County,DeKalb County-Hall County-GA
2021,DeKalb County-New York County-NY-1718,"New York County, NY",1718,2017,2018,205,11648000,172,8808000,33,2840000,DeKalb County,DeKalb County-New York County-NY
2022,DeKalb County-Queens County-NY-1718,"Queens County, NY",1718,2017,2018,253,5887000,104,2007000,149,3880000,DeKalb County,DeKalb County-Queens County-NY
2023,DeKalb County-Jefferson County-AL-1718,"Jefferson County, AL",1718,2017,2018,212,7802000,162,6006000,50,1796000,DeKalb County,DeKalb County-Jefferson County-AL
2024,DeKalb County-Shelby County-TN-1718,"Shelby County, TN",1718,2017,2018,201,4712000,145,3560000,56,1152000,DeKalb County,DeKalb County-Shelby County-TN
2025,DeKalb County-Walton County-GA-1718,"Walton County, GA",1718,2017,2018,189,4877000,323,8254000,-134,-3377000,DeKalb County,DeKalb County-Walton County-GA
2026,DeKalb County-Palm Beach County-FL-1718,"Palm Beach County, FL",1718,2017,2018,206,6055000,118,4063000,88,1992000,DeKalb County,DeKalb County-Palm Beach County-FL
2027,DeKalb County-Bibb County-GA-1718,"Bibb County, GA",1718,2017,2018,181,4798000,142,3159000,39,1639000,DeKalb County,DeKalb County-Bibb County-GA
2028,DeKalb County-Richmond County-GA-1718,"Richmond County, GA",1718,2017,2018,192,4555000,160,2721000,32,1834000,DeKalb County,DeKalb County-Richmond County-GA
2029,DeKalb County-Travis County-TX-1718,"Travis County, TX",1718,2017,2018,166,6271000,90,3318000,76,2953000,DeKalb County,DeKalb County-Travis County-TX
2030,DeKalb County-Franklin County-OH-1718,"Franklin County, OH",1718,2017,2018,183,7820000,205,3751000,-22,4069000,DeKalb County,DeKalb County-Franklin County-OH
2031,DeKalb County-District of Columbia-DC-1718,"District of Columbia, DC",1718,2017,2018,135,7969000,132,6823000,3,1146000,DeKalb County,DeKalb County-District of Columbia-DC
2032,DeKalb County-Muscogee County-GA-1718,"Muscogee County, GA",1718,2017,2018,155,3289000,140,3125000,15,164000,DeKalb County,DeKalb County-Muscogee County-GA
2033,DeKalb County-Maricopa County-AZ-1718,"Maricopa County, AZ",1718,2017,2018,155,6273000,204,7266000,-49,-993000,DeKalb County,DeKalb County-Maricopa County-AZ
2034,DeKalb County-Bronx County-NY-1718,"Bronx County, NY",1718,2017,2018,176,3471000,79,1137000,97,2334000,DeKalb County,DeKalb County-Bronx County-NY
2035,DeKalb County-Coweta County-GA-1718,"Coweta County, GA",1718,2017,2018,142,4108000,193,10069000,-51,-5961000,DeKalb County,DeKalb County-Coweta County-GA
2036,DeKalb County-Paulding County-GA-1718,"Paulding County, GA",1718,2017,2018,159,3810000,216,5007000,-57,-1197000,DeKalb County,DeKalb County-Paulding County-GA
2037,DeKalb County-San Diego County-CA-1718,"San Diego County, CA",1718,2017,2018,151,5921000,124,4113000,27,1808000,DeKalb County,DeKalb County-San Diego County-CA
2038,DeKalb County-King County-WA-1718,"King County, WA",1718,2017,2018,150,10120000,223,13167000,-73,-3047000,DeKalb County,DeKalb County-King County-WA
2039,DeKalb County-Wake County-NC-1718,"Wake County, NC",1718,2017,2018,137,4001000,164,6857000,-27,-2856000,DeKalb County,DeKalb County-Wake County-NC
2040,DeKalb County-Orleans Parish-LA-1718,"Orleans Parish, LA",1718,2017,2018,135,2738000,77,2266000,58,472000,DeKalb County,DeKalb County-Orleans Parish-LA
2041,DeKalb County-Greenville County-SC-1718,"Greenville County, SC",1718,2017,2018,122,4667000,83,3175000,39,1492000,DeKalb County,DeKalb County-Greenville County-SC
2042,DeKalb County-Carroll County-GA-1718,"Carroll County, GA",1718,2017,2018,100,2714000,105,1937000,-5,777000,DeKalb County,DeKalb County-Carroll County-GA
2043,DeKalb County-Leon County-FL-1718,"Leon County, FL",1718,2017,2018,123,3577000,64,2162000,59,1415000,DeKalb County,DeKalb County-Leon County-FL
2044,DeKalb County-Wayne County-MI-1718,"Wayne County, MI",1718,2017,2018,142,2068000,124,1638000,18,430000,DeKalb County,DeKalb County-Wayne County-MI
2045,DeKalb County-Philadelphia County-PA-1718,"Philadelphia County, PA",1718,2017,2018,138,4624000,137,3698000,1,926000,DeKalb County,DeKalb County-Philadelphia County-PA
2046,DeKalb County-Clark County-NV-1718,"Clark County, NV",1718,2017,2018,148,2827000,145,6034000,3,-3207000,DeKalb County,DeKalb County-Clark County-NV
2047,DeKalb County-Charleston County-SC-1718,"Charleston County, SC",1718,2017,2018,114,4073000,128,5154000,-14,-1081000,DeKalb County,DeKalb County-Charleston County-SC
2048,DeKalb County-Dougherty County-GA-1718,"Dougherty County, GA",1718,2017,2018,117,1753000,54,833000,63,920000,DeKalb County,DeKalb County-Dougherty County-GA
2049,DeKalb County-Prince George's County-MD-1718,"Prince George's County, MD",1718,2017,2018,99,3591000,118,2313000,-19,1278000,DeKalb County,DeKalb County-Prince George's County-MD
2050,DeKalb County-Fairfax County-VA-1718,"Fairfax County, VA",1718,2017,2018,124,7063000,98,4830000,26,2233000,DeKalb County,DeKalb County-Fairfax County-VA
2051,DeKalb County-Richland County-SC-1718,"Richland County, SC",1718,2017,2018,116,2813000,98,2213000,18,600000,DeKalb County,DeKalb County-Richland County-SC
2052,DeKalb County-Essex County-NJ-1718,"Essex County, NJ",1718,2017,2018,141,2514000,57,1437000,84,1077000,DeKalb County,DeKalb County-Essex County-NJ
2053,DeKalb County-Tarrant County-TX-1718,"Tarrant County, TX",1718,2017,2018,107,2762000,135,4525000,-28,-1763000,DeKalb County,DeKalb County-Tarrant County-TX
2054,DeKalb County-Pinellas County-FL-1718,"Pinellas County, FL",1718,2017,2018,119,4333000,168,8192000,-49,-3859000,DeKalb County,DeKalb County-Pinellas County-FL
2055,DeKalb County-Alachua County-FL-1718,"Alachua County, FL",1718,2017,2018,106,2609000,37,1469000,69,1140000,DeKalb County,DeKalb County-Alachua County-FL
2056,DeKalb County-Mobile County-AL-1718,"Mobile County, AL",1718,2017,2018,119,2012000,57,1325000,62,687000,DeKalb County,DeKalb County-Mobile County-AL
2057,DeKalb County-Suffolk County-MA-1718,"Suffolk County, MA",1718,2017,2018,94,4527000,70,3503000,24,1024000,DeKalb County,DeKalb County-Suffolk County-MA
2058,DeKalb County-St. Louis County-MO-1718,"St. Louis County, MO",1718,2017,2018,104,3555000,74,2839000,30,716000,DeKalb County,DeKalb County-St. Louis County-MO
2059,DeKalb County-Allegheny County-PA-1718,"Allegheny County, PA",1718,2017,2018,114,3459000,121,3750000,-7,-291000,DeKalb County,DeKalb County-Allegheny County-PA
2060,DeKalb County-Montgomery County-AL-1718,"Montgomery County, AL",1718,2017,2018,92,3097000,50,978000,42,2119000,DeKalb County,DeKalb County-Montgomery County-AL
2061,DeKalb County-Hamilton County-OH-1718,"Hamilton County, OH",1718,2017,2018,123,2785000,115,2623000,8,162000,DeKalb County,DeKalb County-Hamilton County-OH
2062,DeKalb County-Barrow County-GA-1718,"Barrow County, GA",1718,2017,2018,97,2313000,166,3453000,-69,-1140000,DeKalb County,DeKalb County-Barrow County-GA
2063,DeKalb County-Jefferson County-KY-1718,"Jefferson County, KY",1718,2017,2018,106,2525000,131,2850000,-25,-325000,DeKalb County,DeKalb County-Jefferson County-KY
2064,DeKalb County-Montgomery County-MD-1718,"Montgomery County, MD",1718,2017,2018,97,4212000,123,4736000,-26,-524000,DeKalb County,DeKalb County-Montgomery County-MD
2065,DeKalb County-Baltimore city-MD-1718,"Baltimore city, MD",1718,2017,2018,89,2339000,59,1271000,30,1068000,DeKalb County,DeKalb County-Baltimore city-MD
2066,DeKalb County-Alameda County-CA-1718,"Alameda County, CA",1718,2017,2018,95,5776000,71,3342000,24,2434000,DeKalb County,DeKalb County-Alameda County-CA
2067,DeKalb County-Houston County-GA-1718,"Houston County, GA",1718,2017,2018,89,2286000,89,1878000,0,408000,DeKalb County,DeKalb County-Houston County-GA
2068,DeKalb County-Hamilton County-TN-1718,"Hamilton County, TN",1718,2017,2018,83,2895000,103,3895000,-20,-1000000,DeKalb County,DeKalb County-Hamilton County-TN
2069,DeKalb County-Fairfield County-CT-1718,"Fairfield County, CT",1718,2017,2018,89,4132000,37,1811000,52,2321000,DeKalb County,DeKalb County-Fairfield County-CT
2070,DeKalb County-Spalding County-GA-1718,"Spalding County, GA",1718,2017,2018,98,1573000,114,2306000,-16,-733000,DeKalb County,DeKalb County-Spalding County-GA
2071,DeKalb County-Lowndes County-GA-1718,"Lowndes County, GA",1718,2017,2018,86,1918000,49,938000,37,980000,DeKalb County,DeKalb County-Lowndes County-GA
2072,DeKalb County-Marion County-IN-1718,"Marion County, IN",1718,2017,2018,88,1754000,141,2645000,-53,-891000,DeKalb County,DeKalb County-Marion County-IN
2073,DeKalb County-Nassau County-NY-1718,"Nassau County, NY",1718,2017,2018,90,2796000,43,1377000,47,1419000,DeKalb County,DeKalb County-Nassau County-NY
2074,DeKalb County-Middlesex County-MA-1718,"Middlesex County, MA",1718,2017,2018,71,4130000,93,3357000,-22,773000,DeKalb County,DeKalb County-Middlesex County-MA
2075,DeKalb County-Westchester County-NY-1718,"Westchester County, NY",1718,2017,2018,95,3824000,59,3449000,36,375000,DeKalb County,DeKalb County-Westchester County-NY
2076,DeKalb County-Hartford County-CT-1718,"Hartford County, CT",1718,2017,2018,111,4110000,53,1139000,58,2971000,DeKalb County,DeKalb County-Hartford County-CT
2077,DeKalb County-Guilford County-NC-1718,"Guilford County, NC",1718,2017,2018,77,1750000,91,2521000,-14,-771000,DeKalb County,DeKalb County-Guilford County-NC
2078,DeKalb County-Santa Clara County-CA-1718,"Santa Clara County, CA",1718,2017,2018,97,5772000,128,8321000,-31,-2549000,DeKalb County,DeKalb County-Santa Clara County-CA
2079,DeKalb County-Cuyahoga County-OH-1718,"Cuyahoga County, OH",1718,2017,2018,82,2981000,115,2773000,-33,208000,DeKalb County,DeKalb County-Cuyahoga County-OH
2080,DeKalb County-Seminole County-FL-1718,"Seminole County, FL",1718,2017,2018,66,2282000,52,1690000,14,592000,DeKalb County,DeKalb County-Seminole County-FL
2081,DeKalb County-San Francisco County-CA-1718,"San Francisco County, CA",1718,2017,2018,64,6287000,64,4192000,0,2095000,DeKalb County,DeKalb County-San Francisco County-CA
2082,DeKalb County-Columbia County-GA-1718,"Columbia County, GA",1718,2017,2018,75,2916000,79,2145000,-4,771000,DeKalb County,DeKalb County-Columbia County-GA
2083,DeKalb County-Denver County-CO-1718,"Denver County, CO",1718,2017,2018,72,3219000,98,6055000,-26,-2836000,DeKalb County,DeKalb County-Denver County-CO
2084,DeKalb County-Knox County-TN-1718,"Knox County, TN",1718,2017,2018,70,2520000,126,3460000,-56,-940000,DeKalb County,DeKalb County-Knox County-TN
2085,DeKalb County-Hudson County-NJ-1718,"Hudson County, NJ",1718,2017,2018,71,3313000,44,2138000,27,1175000,DeKalb County,DeKalb County-Hudson County-NJ
2086,DeKalb County-Durham County-NC-1718,"Durham County, NC",1718,2017,2018,69,4107000,69,3365000,0,742000,DeKalb County,DeKalb County-Durham County-NC
2087,DeKalb County-Lee County-AL-1718,"Lee County, AL",1718,2017,2018,63,1859000,50,1496000,13,363000,DeKalb County,DeKalb County-Lee County-AL
2088,DeKalb County-Escambia County-FL-1718,"Escambia County, FL",1718,2017,2018,77,3262000,51,1349000,26,1913000,DeKalb County,DeKalb County-Escambia County-FL
2089,DeKalb County-Volusia County-FL-1718,"Volusia County, FL",1718,2017,2018,66,1413000,41,1396000,25,17000,DeKalb County,DeKalb County-Volusia County-FL
2090,DeKalb County-Glynn County-GA-1718,"Glynn County, GA",1718,2017,2018,65,1608000,63,2100000,2,-492000,DeKalb County,DeKalb County-Glynn County-GA
2091,DeKalb County-Milwaukee County-WI-1718,"Milwaukee County, WI",1718,2017,2018,94,1264000,88,1399000,6,-135000,DeKalb County,DeKalb County-Milwaukee County-WI
2092,DeKalb County-Oakland County-MI-1718,"Oakland County, MI",1718,2017,2018,72,2294000,76,3550000,-4,-1256000,DeKalb County,DeKalb County-Oakland County-MI
2093,DeKalb County-Hennepin County-MN-1718,"Hennepin County, MN",1718,2017,2018,62,2300000,97,3134000,-35,-834000,DeKalb County,DeKalb County-Hennepin County-MN
2094,DeKalb County-East Baton Rouge Parish-LA-1718,"East Baton Rouge Parish, LA",1718,2017,2018,71,1282000,34,706000,37,576000,DeKalb County,DeKalb County-East Baton Rouge Parish-LA
2095,DeKalb County-Bartow County-GA-1718,"Bartow County, GA",1718,2017,2018,74,1646000,64,1663000,10,-17000,DeKalb County,DeKalb County-Bartow County-GA
2096,DeKalb County-Erie County-NY-1718,"Erie County, NY",1718,2017,2018,83,2554000,70,852000,13,1702000,DeKalb County,DeKalb County-Erie County-NY
2097,DeKalb County-New Haven County-CT-1718,"New Haven County, CT",1718,2017,2018,55,2116000,31,1279000,24,837000,DeKalb County,DeKalb County-New Haven County-CT
2098,DeKalb County-Bexar County-TX-1718,"Bexar County, TX",1718,2017,2018,77,2283000,69,2047000,8,236000,DeKalb County,DeKalb County-Bexar County-TX
2099,DeKalb County-Brevard County-FL-1718,"Brevard County, FL",1718,2017,2018,71,1595000,72,3588000,-1,-1993000,DeKalb County,DeKalb County-Brevard County-FL
2100,DeKalb County-Henrico County-VA-1718,"Henrico County, VA",1718,2017,2018,81,3098000,54,1733000,27,1365000,DeKalb County,DeKalb County-Henrico County-VA
2101,DeKalb County-Norfolk city-VA-1718,"Norfolk city, VA",1718,2017,2018,69,1295000,32,753000,37,542000,DeKalb County,DeKalb County-Norfolk city-VA
2102,DeKalb County-Orange County-CA-1718,"Orange County, CA",1718,2017,2018,69,3769000,106,6048000,-37,-2279000,DeKalb County,DeKalb County-Orange County-CA
2103,DeKalb County-Jefferson Parish-LA-1718,"Jefferson Parish, LA",1718,2017,2018,61,1523000,47,485000,14,1038000,DeKalb County,DeKalb County-Jefferson Parish-LA
2104,DeKalb County-Forsyth County-NC-1718,"Forsyth County, NC",1718,2017,2018,52,1483000,41,1204000,11,279000,DeKalb County,DeKalb County-Forsyth County-NC
2105,DeKalb County-Beaufort County-SC-1718,"Beaufort County, SC",1718,2017,2018,51,3307000,44,2100000,7,1207000,DeKalb County,DeKalb County-Beaufort County-SC
2106,DeKalb County-Madison County-AL-1718,"Madison County, AL",1718,2017,2018,41,1118000,84,1784000,-43,-666000,DeKalb County,DeKalb County-Madison County-AL
2107,DeKalb County-Lee County-FL-1718,"Lee County, FL",1718,2017,2018,63,3419000,49,4554000,14,-1135000,DeKalb County,DeKalb County-Lee County-FL
2108,DeKalb County-Bergen County-NJ-1718,"Bergen County, NJ",1718,2017,2018,56,2544000,36,1361000,20,1183000,DeKalb County,DeKalb County-Bergen County-NJ
2109,DeKalb County-Buncombe County-NC-1718,"Buncombe County, NC",1718,2017,2018,37,1927000,92,7226000,-55,-5299000,DeKalb County,DeKalb County-Buncombe County-NC
2110,DeKalb County-Arapahoe County-CO-1718,"Arapahoe County, CO",1718,2017,2018,46,2027000,70,2330000,-24,-303000,DeKalb County,DeKalb County-Arapahoe County-CO
2111,DeKalb County-Collin County-TX-1718,"Collin County, TX",1718,2017,2018,60,1882000,87,3012000,-27,-1130000,DeKalb County,DeKalb County-Collin County-TX
2112,DeKalb County-Anne Arundel County-MD-1718,"Anne Arundel County, MD",1718,2017,2018,39,1481000,38,2100000,1,-619000,DeKalb County,DeKalb County-Anne Arundel County-MD
2113,DeKalb County-Honolulu County-HI-1718,"Honolulu County, HI",1718,2017,2018,51,2221000,63,1929000,-12,292000,DeKalb County,DeKalb County-Honolulu County-HI
2114,DeKalb County-Baltimore County-MD-1718,"Baltimore County, MD",1718,2017,2018,63,1170000,63,1574000,0,-404000,DeKalb County,DeKalb County-Baltimore County-MD
2115,DeKalb County-Denton County-TX-1718,"Denton County, TX",1718,2017,2018,38,1642000,57,2844000,-19,-1202000,DeKalb County,DeKalb County-Denton County-TX
2116,DeKalb County-San Bernardino County-CA-1718,"San Bernardino County, CA",1718,2017,2018,40,848000,57,955000,-17,-107000,DeKalb County,DeKalb County-San Bernardino County-CA
2117,DeKalb County-Polk County-FL-1718,"Polk County, FL",1718,2017,2018,38,922000,70,1226000,-32,-304000,DeKalb County,DeKalb County-Polk County-FL
2118,DeKalb County-Oconee County-GA-1718,"Oconee County, GA",1718,2017,2018,34,1568000,54,3209000,-20,-1641000,DeKalb County,DeKalb County-Oconee County-GA
2119,DeKalb County-Loudoun County-VA-1718,"Loudoun County, VA",1718,2017,2018,49,2748000,43,2012000,6,736000,DeKalb County,DeKalb County-Loudoun County-VA
2120,DeKalb County-Virginia Beach city-VA-1718,"Virginia Beach city, VA",1718,2017,2018,47,1909000,47,802000,0,1107000,DeKalb County,DeKalb County-Virginia Beach city-VA
2121,DeKalb County-Washtenaw County-MI-1718,"Washtenaw County, MI",1718,2017,2018,40,1911000,39,2210000,1,-299000,DeKalb County,DeKalb County-Washtenaw County-MI
2122,DeKalb County-Montgomery County-PA-1718,"Montgomery County, PA",1718,2017,2018,42,2128000,51,2001000,-9,127000,DeKalb County,DeKalb County-Montgomery County-PA
2123,DeKalb County-Sacramento County-CA-1718,"Sacramento County, CA",1718,2017,2018,52,1297000,52,1497000,0,-200000,DeKalb County,DeKalb County-Sacramento County-CA
2124,DeKalb County-Troup County-GA-1718,"Troup County, GA",1718,2017,2018,39,805000,45,671000,-6,134000,DeKalb County,DeKalb County-Troup County-GA
2125,DeKalb County-Montgomery County-OH-1718,"Montgomery County, OH",1718,2017,2018,43,861000,44,609000,-1,252000,DeKalb County,DeKalb County-Montgomery County-OH
2126,DeKalb County-Arlington County-VA-1718,"Arlington County, VA",1718,2017,2018,32,1980000,37,2217000,-5,-237000,DeKalb County,DeKalb County-Arlington County-VA
2127,DeKalb County-Jackson County-GA-1718,"Jackson County, GA",1718,2017,2018,31,1146000,73,2327000,-42,-1181000,DeKalb County,DeKalb County-Jackson County-GA
2128,DeKalb County-Pierce County-WA-1718,"Pierce County, WA",1718,2017,2018,33,925000,40,720000,-7,205000,DeKalb County,DeKalb County-Pierce County-WA
2129,DeKalb County-Bay County-FL-1718,"Bay County, FL",1718,2017,2018,33,911000,50,1328000,-17,-417000,DeKalb County,DeKalb County-Bay County-FL
2130,DeKalb County-Multnomah County-OR-1718,"Multnomah County, OR",1718,2017,2018,36,1455000,50,2375000,-14,-920000,DeKalb County,DeKalb County-Multnomah County-OR
2131,DeKalb County-Dane County-WI-1718,"Dane County, WI",1718,2017,2018,32,1431000,36,1785000,-4,-354000,DeKalb County,DeKalb County-Dane County-WI
2132,DeKalb County-Baldwin County-AL-1718,"Baldwin County, AL",1718,2017,2018,31,356000,40,1832000,-9,-1476000,DeKalb County,DeKalb County-Baldwin County-AL
2133,DeKalb County-Sarasota County-FL-1718,"Sarasota County, FL",1718,2017,2018,24,2355000,52,1635000,-28,720000,DeKalb County,DeKalb County-Sarasota County-FL
2134,DeKalb County-Baldwin County-GA-1718,"Baldwin County, GA",1718,2017,2018,37,894000,50,1056000,-13,-162000,DeKalb County,DeKalb County-Baldwin County-GA
2135,DeKalb County-Ramsey County-MN-1718,"Ramsey County, MN",1718,2017,2018,40,935000,77,1134000,-37,-199000,DeKalb County,DeKalb County-Ramsey County-MN
2136,DeKalb County-Horry County-SC-1718,"Horry County, SC",1718,2017,2018,31,795000,38,856000,-7,-61000,DeKalb County,DeKalb County-Horry County-SC
2137,DeKalb County-Salt Lake County-UT-1718,"Salt Lake County, UT",1718,2017,2018,26,969000,34,1257000,-8,-288000,DeKalb County,DeKalb County-Salt Lake County-UT
2138,DeKalb County-El Paso County-CO-1718,"El Paso County, CO",1718,2017,2018,33,809000,38,1337000,-5,-528000,DeKalb County,DeKalb County-El Paso County-CO
2139,DeKalb County-Osceola County-FL-1718,"Osceola County, FL",1718,2017,2018,34,1201000,49,921000,-15,280000,DeKalb County,DeKalb County-Osceola County-FL
2140,DeKalb County-Cumberland County-NC-1718,"Cumberland County, NC",1718,2017,2018,39,677000,61,718000,-22,-41000,DeKalb County,DeKalb County-Cumberland County-NC
2142,Douglas County-Cobb County-GA-1718,"Cobb County, GA",1718,2017,2018,2910,48148000,1975,38316000,935,9832000,Douglas County,Douglas County-Cobb County-GA
2143,Douglas County-Fulton County-GA-1718,"Fulton County, GA",1718,2017,2018,1736,31785000,1414,31886000,322,-101000,Douglas County,Douglas County-Fulton County-GA
2144,Douglas County-Paulding County-GA-1718,"Paulding County, GA",1718,2017,2018,1086,21957000,1227,24000000,-141,-2043000,Douglas County,Douglas County-Paulding County-GA
2145,Douglas County-Carroll County-GA-1718,"Carroll County, GA",1718,2017,2018,947,26774000,1381,32218000,-434,-5444000,Douglas County,Douglas County-Carroll County-GA
2146,Douglas County-DeKalb County-GA-1718,"DeKalb County, GA",1718,2017,2018,478,9365000,402,8331000,76,1034000,Douglas County,Douglas County-DeKalb County-GA
2147,Douglas County-Clayton County-GA-1718,"Clayton County, GA",1718,2017,2018,451,6512000,319,4278000,132,2234000,Douglas County,Douglas County-Clayton County-GA
2148,Douglas County-Gwinnett County-GA-1718,"Gwinnett County, GA",1718,2017,2018,292,5881000,362,7384000,-70,-1503000,Douglas County,Douglas County-Gwinnett County-GA
2149,Douglas County-Henry County-GA-1718,"Henry County, GA",1718,2017,2018,149,3014000,164,3560000,-15,-546000,Douglas County,Douglas County-Henry County-GA
2150,Douglas County-Broward County-FL-1718,"Broward County, FL",1718,2017,2018,99,2022000,53,1686000,46,336000,Douglas County,Douglas County-Broward County-FL
2151,Douglas County-Cherokee County-GA-1718,"Cherokee County, GA",1718,2017,2018,95,2079000,96,3002000,-1,-923000,Douglas County,Douglas County-Cherokee County-GA
2152,Douglas County-Coweta County-GA-1718,"Coweta County, GA",1718,2017,2018,89,1646000,131,3097000,-42,-1451000,Douglas County,Douglas County-Coweta County-GA
2153,Douglas County-Haralson County-GA-1718,"Haralson County, GA",1718,2017,2018,83,1424000,195,5128000,-112,-3704000,Douglas County,Douglas County-Haralson County-GA
2154,Douglas County-Rockdale County-GA-1718,"Rockdale County, GA",1718,2017,2018,62,918000,41,744000,21,174000,Douglas County,Douglas County-Rockdale County-GA
2155,Douglas County-Fayette County-GA-1718,"Fayette County, GA",1718,2017,2018,50,1312000,92,3232000,-42,-1920000,Douglas County,Douglas County-Fayette County-GA
2156,Douglas County-Jefferson County-AL-1718,"Jefferson County, AL",1718,2017,2018,38,976000,31,1054000,7,-78000,Douglas County,Douglas County-Jefferson County-AL
2157,Douglas County-Hillsborough County-FL-1718,"Hillsborough County, FL",1718,2017,2018,39,1089000,53,1110000,-14,-21000,Douglas County,Douglas County-Hillsborough County-FL
2158,Douglas County-Bartow County-GA-1718,"Bartow County, GA",1718,2017,2018,57,782000,59,1115000,-2,-333000,Douglas County,Douglas County-Bartow County-GA
2159,Douglas County-Newton County-GA-1718,"Newton County, GA",1718,2017,2018,36,805000,44,1102000,-8,-297000,Douglas County,Douglas County-Newton County-GA
2161,Fayette County-Fulton County-GA-1718,"Fulton County, GA",1718,2017,2018,1147,39175000,918,39404000,229,-229000,Fayette County,Fayette County-Fulton County-GA
2162,Fayette County-Clayton County-GA-1718,"Clayton County, GA",1718,2017,2018,968,19429000,554,15941000,414,3488000,Fayette County,Fayette County-Clayton County-GA
2163,Fayette County-Coweta County-GA-1718,"Coweta County, GA",1718,2017,2018,987,35337000,1515,54145000,-528,-18808000,Fayette County,Fayette County-Coweta County-GA
2164,Fayette County-Henry County-GA-1718,"Henry County, GA",1718,2017,2018,424,13613000,338,8952000,86,4661000,Fayette County,Fayette County-Henry County-GA
2165,Fayette County-Cobb County-GA-1718,"Cobb County, GA",1718,2017,2018,240,10570000,267,16222000,-27,-5652000,Fayette County,Fayette County-Cobb County-GA
2166,Fayette County-DeKalb County-GA-1718,"DeKalb County, GA",1718,2017,2018,246,7402000,231,9673000,15,-2271000,Fayette County,Fayette County-DeKalb County-GA
2167,Fayette County-Los Angeles County-CA-1718,"Los Angeles County, CA",1718,2017,2018,168,7688000,53,2503000,115,5185000,Fayette County,Fayette County-Los Angeles County-CA
2168,Fayette County-Gwinnett County-GA-1718,"Gwinnett County, GA",1718,2017,2018,145,5216000,158,4526000,-13,690000,Fayette County,Fayette County-Gwinnett County-GA
2169,Fayette County-Spalding County-GA-1718,"Spalding County, GA",1718,2017,2018,143,4280000,222,6563000,-79,-2283000,Fayette County,Fayette County-Spalding County-GA
2170,Fayette County-Douglas County-GA-1718,"Douglas County, GA",1718,2017,2018,92,3232000,50,1312000,42,1920000,Fayette County,Fayette County-Douglas County-GA
2172,Forsyth County-Fulton County-GA-1718,"Fulton County, GA",1718,2017,2018,5201,217872000,2473,169920000,2728,47952000,Forsyth County,Forsyth County-Fulton County-GA
2173,Forsyth County-Gwinnett County-GA-1718,"Gwinnett County, GA",1718,2017,2018,2415,102375000,1417,49271000,998,53104000,Forsyth County,Forsyth County-Gwinnett County-GA
2174,Forsyth County-Cobb County-GA-1718,"Cobb County, GA",1718,2017,2018,931,46798000,466,18088000,465,28710000,Forsyth County,Forsyth County-Cobb County-GA
2175,Forsyth County-DeKalb County-GA-1718,"DeKalb County, GA",1718,2017,2018,868,38377000,376,12526000,492,25851000,Forsyth County,Forsyth County-DeKalb County-GA
2176,Forsyth County-Hall County-GA-1718,"Hall County, GA",1718,2017,2018,620,16504000,742,29704000,-122,-13200000,Forsyth County,Forsyth County-Hall County-GA
2177,Forsyth County-Cherokee County-GA-1718,"Cherokee County, GA",1718,2017,2018,586,19402000,871,38178000,-285,-18776000,Forsyth County,Forsyth County-Cherokee County-GA
2178,Forsyth County-Dawson County-GA-1718,"Dawson County, GA",1718,2017,2018,512,12518000,796,29608000,-284,-17090000,Forsyth County,Forsyth County-Dawson County-GA
2179,Forsyth County-Lumpkin County-GA-1718,"Lumpkin County, GA",1718,2017,2018,207,4537000,320,10528000,-113,-5991000,Forsyth County,Forsyth County-Lumpkin County-GA
2180,Forsyth County-Broward County-FL-1718,"Broward County, FL",1718,2017,2018,173,7852000,55,2407000,118,5445000,Forsyth County,Forsyth County-Broward County-FL
2181,Forsyth County-Los Angeles County-CA-1718,"Los Angeles County, CA",1718,2017,2018,112,4480000,42,1678000,70,2802000,Forsyth County,Forsyth County-Los Angeles County-CA
2182,Forsyth County-Maricopa County-AZ-1718,"Maricopa County, AZ",1718,2017,2018,94,3958000,79,3583000,15,375000,Forsyth County,Forsyth County-Maricopa County-AZ
2183,Forsyth County-Orange County-FL-1718,"Orange County, FL",1718,2017,2018,81,2948000,47,2802000,34,146000,Forsyth County,Forsyth County-Orange County-FL
2184,Forsyth County-Barrow County-GA-1718,"Barrow County, GA",1718,2017,2018,56,1553000,99,2376000,-43,-823000,Forsyth County,Forsyth County-Barrow County-GA
2185,Forsyth County-Paulding County-GA-1718,"Paulding County, GA",1718,2017,2018,92,2125000,55,1499000,37,626000,Forsyth County,Forsyth County-Paulding County-GA
2186,Forsyth County-Harris County-TX-1718,"Harris County, TX",1718,2017,2018,81,4610000,53,2312000,28,2298000,Forsyth County,Forsyth County-Harris County-TX
2187,Forsyth County-Clarke County-GA-1718,"Clarke County, GA",1718,2017,2018,48,1497000,51,1645000,-3,-148000,Forsyth County,Forsyth County-Clarke County-GA
2188,Forsyth County-Pickens County-GA-1718,"Pickens County, GA",1718,2017,2018,63,2400000,135,5542000,-72,-3142000,Forsyth County,Forsyth County-Pickens County-GA
2189,Forsyth County-Palm Beach County-FL-1718,"Palm Beach County, FL",1718,2017,2018,61,1732000,52,3674000,9,-1942000,Forsyth County,Forsyth County-Palm Beach County-FL
2190,Forsyth County-Hillsborough County-FL-1718,"Hillsborough County, FL",1718,2017,2018,76,4299000,64,3239000,12,1060000,Forsyth County,Forsyth County-Hillsborough County-FL
2191,Forsyth County-Jackson County-GA-1718,"Jackson County, GA",1718,2017,2018,72,1823000,93,3056000,-21,-1233000,Forsyth County,Forsyth County-Jackson County-GA
2192,Forsyth County-Mecklenburg County-NC-1718,"Mecklenburg County, NC",1718,2017,2018,56,2451000,62,2673000,-6,-222000,Forsyth County,Forsyth County-Mecklenburg County-NC
2193,Forsyth County-Dallas County-TX-1718,"Dallas County, TX",1718,2017,2018,46,2029000,51,2360000,-5,-331000,Forsyth County,Forsyth County-Dallas County-TX
2194,Forsyth County-Wake County-NC-1718,"Wake County, NC",1718,2017,2018,57,4155000,56,2897000,1,1258000,Forsyth County,Forsyth County-Wake County-NC
2195,Forsyth County-White County-GA-1718,"White County, GA",1718,2017,2018,47,1556000,69,2265000,-22,-709000,Forsyth County,Forsyth County-White County-GA
2196,Forsyth County-King County-WA-1718,"King County, WA",1718,2017,2018,45,1613000,51,3166000,-6,-1553000,Forsyth County,Forsyth County-King County-WA
2197,Forsyth County-Hamilton County-TN-1718,"Hamilton County, TN",1718,2017,2018,48,2361000,40,1172000,8,1189000,Forsyth County,Forsyth County-Hamilton County-TN
2199,Fulton County-DeKalb County-GA-1718,"DeKalb County, GA",1718,2017,2018,14050,745376000,14113,591527000,-63,153849000,Fulton County,Fulton County-DeKalb County-GA
2200,Fulton County-Cobb County-GA-1718,"Cobb County, GA",1718,2017,2018,8414,392148000,9292,388957000,-878,3191000,Fulton County,Fulton County-Cobb County-GA
2201,Fulton County-Gwinnett County-GA-1718,"Gwinnett County, GA",1718,2017,2018,6041,216365000,6151,226372000,-110,-10007000,Fulton County,Fulton County-Gwinnett County-GA
2202,Fulton County-Clayton County-GA-1718,"Clayton County, GA",1718,2017,2018,6372,78495000,7672,98687000,-1300,-20192000,Fulton County,Fulton County-Clayton County-GA
2203,Fulton County-Forsyth County-GA-1718,"Forsyth County, GA",1718,2017,2018,2473,169920000,5201,217872000,-2728,-47952000,Fulton County,Fulton County-Forsyth County-GA
2204,Fulton County-Cherokee County-GA-1718,"Cherokee County, GA",1718,2017,2018,1336,56432000,2496,111313000,-1160,-54881000,Fulton County,Fulton County-Cherokee County-GA
2205,Fulton County-Henry County-GA-1718,"Henry County, GA",1718,2017,2018,1336,41940000,1501,29905000,-165,12035000,Fulton County,Fulton County-Henry County-GA
2206,Fulton County-Douglas County-GA-1718,"Douglas County, GA",1718,2017,2018,1414,31886000,1736,31785000,-322,101000,Fulton County,Fulton County-Douglas County-GA
2207,Fulton County-Cook County-IL-1718,"Cook County, IL",1718,2017,2018,859,46788000,630,34186000,229,12602000,Fulton County,Fulton County-Cook County-IL
2208,Fulton County-Los Angeles County-CA-1718,"Los Angeles County, CA",1718,2017,2018,832,47108000,675,38060000,157,9048000,Fulton County,Fulton County-Los Angeles County-CA
2209,Fulton County-Fayette County-GA-1718,"Fayette County, GA",1718,2017,2018,918,39404000,1147,39175000,-229,229000,Fulton County,Fulton County-Fayette County-GA
2210,Fulton County-Coweta County-GA-1718,"Coweta County, GA",1718,2017,2018,800,21476000,854,24408000,-54,-2932000,Fulton County,Fulton County-Coweta County-GA
2211,Fulton County-New York County-NY-1718,"New York County, NY",1718,2017,2018,534,48253000,517,53828000,17,-5575000,Fulton County,Fulton County-New York County-NY
2212,Fulton County-Miami-Dade County-FL-1718,"Miami-Dade County, FL",1718,2017,2018,686,23955000,324,50174000,362,-26219000,Fulton County,Fulton County-Miami-Dade County-FL
2213,Fulton County-Broward County-FL-1718,"Broward County, FL",1718,2017,2018,675,26609000,394,28109000,281,-1500000,Fulton County,Fulton County-Broward County-FL
2214,Fulton County-Mecklenburg County-NC-1718,"Mecklenburg County, NC",1718,2017,2018,577,33087000,490,33485000,87,-398000,Fulton County,Fulton County-Mecklenburg County-NC
2215,Fulton County-Harris County-TX-1718,"Harris County, TX",1718,2017,2018,553,32512000,377,22133000,176,10379000,Fulton County,Fulton County-Harris County-TX
2216,Fulton County-Kings County-NY-1718,"Kings County, NY",1718,2017,2018,437,22260000,275,20647000,162,1613000,Fulton County,Fulton County-Kings County-NY
2217,Fulton County-Hillsborough County-FL-1718,"Hillsborough County, FL",1718,2017,2018,451,20535000,358,34678000,93,-14143000,Fulton County,Fulton County-Hillsborough County-FL
2218,Fulton County-Rockdale County-GA-1718,"Rockdale County, GA",1718,2017,2018,461,10804000,351,6624000,110,4180000,Fulton County,Fulton County-Rockdale County-GA
2219,Fulton County-Davidson County-TN-1718,"Davidson County, TN",1718,2017,2018,357,20851000,314,20149000,43,702000,Fulton County,Fulton County-Davidson County-TN
2220,Fulton County-Dallas County-TX-1718,"Dallas County, TX",1718,2017,2018,368,21403000,378,29914000,-10,-8511000,Fulton County,Fulton County-Dallas County-TX
2221,Fulton County-Orange County-FL-1718,"Orange County, FL",1718,2017,2018,394,15383000,290,11836000,104,3547000,Fulton County,Fulton County-Orange County-FL
2222,Fulton County-Chatham County-GA-1718,"Chatham County, GA",1718,2017,2018,373,13739000,290,11899000,83,1840000,Fulton County,Fulton County-Chatham County-GA
2223,Fulton County-Paulding County-GA-1718,"Paulding County, GA",1718,2017,2018,453,11624000,535,8541000,-82,3083000,Fulton County,Fulton County-Paulding County-GA
2224,Fulton County-Jefferson County-AL-1718,"Jefferson County, AL",1718,2017,2018,377,21038000,275,15156000,102,5882000,Fulton County,Fulton County-Jefferson County-AL
2225,Fulton County-Palm Beach County-FL-1718,"Palm Beach County, FL",1718,2017,2018,388,24078000,270,35495000,118,-11417000,Fulton County,Fulton County-Palm Beach County-FL
2226,Fulton County-District of Columbia-DC-1718,"District of Columbia, DC",1718,2017,2018,272,24666000,247,14581000,25,10085000,Fulton County,Fulton County-District of Columbia-DC
2227,Fulton County-Wake County-NC-1718,"Wake County, NC",1718,2017,2018,361,18628000,259,12850000,102,5778000,Fulton County,Fulton County-Wake County-NC
2228,Fulton County-Duval County-FL-1718,"Duval County, FL",1718,2017,2018,362,29710000,292,13578000,70,16132000,Fulton County,Fulton County-Duval County-FL
2229,Fulton County-Clarke County-GA-1718,"Clarke County, GA",1718,2017,2018,280,9715000,236,6672000,44,3043000,Fulton County,Fulton County-Clarke County-GA
2230,Fulton County-Hall County-GA-1718,"Hall County, GA",1718,2017,2018,300,12085000,369,19474000,-69,-7389000,Fulton County,Fulton County-Hall County-GA
2231,Fulton County-Maricopa County-AZ-1718,"Maricopa County, AZ",1718,2017,2018,335,16802000,271,19161000,64,-2359000,Fulton County,Fulton County-Maricopa County-AZ
2232,Fulton County-Shelby County-TN-1718,"Shelby County, TN",1718,2017,2018,314,14809000,156,5167000,158,9642000,Fulton County,Fulton County-Shelby County-TN
2233,Fulton County-Travis County-TX-1718,"Travis County, TX",1718,2017,2018,292,29695000,222,14900000,70,14795000,Fulton County,Fulton County-Travis County-TX
2234,Fulton County-Muscogee County-GA-1718,"Muscogee County, GA",1718,2017,2018,290,12515000,194,8621000,96,3894000,Fulton County,Fulton County-Muscogee County-GA
2235,Fulton County-King County-WA-1718,"King County, WA",1718,2017,2018,287,15161000,461,30396000,-174,-15235000,Fulton County,Fulton County-King County-WA
2236,Fulton County-Newton County-GA-1718,"Newton County, GA",1718,2017,2018,282,5973000,373,6179000,-91,-206000,Fulton County,Fulton County-Newton County-GA
2237,Fulton County-Queens County-NY-1718,"Queens County, NY",1718,2017,2018,266,9949000,124,4777000,142,5172000,Fulton County,Fulton County-Queens County-NY
2238,Fulton County-Carroll County-GA-1718,"Carroll County, GA",1718,2017,2018,213,5637000,171,4992000,42,645000,Fulton County,Fulton County-Carroll County-GA
2239,Fulton County-Prince George's County-MD-1718,"Prince George's County, MD",1718,2017,2018,224,6760000,121,3524000,103,3236000,Fulton County,Fulton County-Prince George's County-MD
2240,Fulton County-Fairfax County-VA-1718,"Fairfax County, VA",1718,2017,2018,222,12126000,188,16830000,34,-4704000,Fulton County,Fulton County-Fairfax County-VA
2241,Fulton County-Philadelphia County-PA-1718,"Philadelphia County, PA",1718,2017,2018,202,8169000,166,6463000,36,1706000,Fulton County,Fulton County-Philadelphia County-PA
2242,Fulton County-Middlesex County-MA-1718,"Middlesex County, MA",1718,2017,2018,213,14393000,185,11988000,28,2405000,Fulton County,Fulton County-Middlesex County-MA
2243,Fulton County-Charleston County-SC-1718,"Charleston County, SC",1718,2017,2018,178,7197000,218,13997000,-40,-6800000,Fulton County,Fulton County-Charleston County-SC
2244,Fulton County-San Diego County-CA-1718,"San Diego County, CA",1718,2017,2018,224,10881000,229,12920000,-5,-2039000,Fulton County,Fulton County-San Diego County-CA
2245,Fulton County-Montgomery County-MD-1718,"Montgomery County, MD",1718,2017,2018,202,12554000,157,6890000,45,5664000,Fulton County,Fulton County-Montgomery County-MD
2246,Fulton County-Bibb County-GA-1718,"Bibb County, GA",1718,2017,2018,205,6378000,198,4093000,7,2285000,Fulton County,Fulton County-Bibb County-GA
2247,Fulton County-Richland County-SC-1718,"Richland County, SC",1718,2017,2018,186,10017000,121,5383000,65,4634000,Fulton County,Fulton County-Richland County-SC
2248,Fulton County-Wayne County-MI-1718,"Wayne County, MI",1718,2017,2018,215,6288000,122,2929000,93,3359000,Fulton County,Fulton County-Wayne County-MI
2249,Fulton County-Santa Clara County-CA-1718,"Santa Clara County, CA",1718,2017,2018,212,15038000,285,16827000,-73,-1789000,Fulton County,Fulton County-Santa Clara County-CA
2250,Fulton County-Orange County-CA-1718,"Orange County, CA",1718,2017,2018,225,16388000,247,16452000,-22,-64000,Fulton County,Fulton County-Orange County-CA
2251,Fulton County-Pinellas County-FL-1718,"Pinellas County, FL",1718,2017,2018,178,8411000,206,11533000,-28,-3122000,Fulton County,Fulton County-Pinellas County-FL
2252,Fulton County-Alachua County-FL-1718,"Alachua County, FL",1718,2017,2018,145,5013000,63,2027000,82,2986000,Fulton County,Fulton County-Alachua County-FL
2253,Fulton County-Hennepin County-MN-1718,"Hennepin County, MN",1718,2017,2018,191,15405000,116,6616000,75,8789000,Fulton County,Fulton County-Hennepin County-MN
2254,Fulton County-Alameda County-CA-1718,"Alameda County, CA",1718,2017,2018,185,10409000,194,10232000,-9,177000,Fulton County,Fulton County-Alameda County-CA
2255,Fulton County-Leon County-FL-1718,"Leon County, FL",1718,2017,2018,155,7063000,83,4775000,72,2288000,Fulton County,Fulton County-Leon County-FL
2256,Fulton County-Collin County-TX-1718,"Collin County, TX",1718,2017,2018,188,9895000,244,13668000,-56,-3773000,Fulton County,Fulton County-Collin County-TX
2257,Fulton County-Richmond County-GA-1718,"Richmond County, GA",1718,2017,2018,150,4594000,162,4534000,-12,60000,Fulton County,Fulton County-Richmond County-GA
2258,Fulton County-Suffolk County-MA-1718,"Suffolk County, MA",1718,2017,2018,131,9567000,114,7208000,17,2359000,Fulton County,Fulton County-Suffolk County-MA
2259,Fulton County-Guilford County-NC-1718,"Guilford County, NC",1718,2017,2018,174,5056000,47,2003000,127,3053000,Fulton County,Fulton County-Guilford County-NC
2260,Fulton County-Cuyahoga County-OH-1718,"Cuyahoga County, OH",1718,2017,2018,178,7470000,114,4027000,64,3443000,Fulton County,Fulton County-Cuyahoga County-OH
2261,Fulton County-Hamilton County-TN-1718,"Hamilton County, TN",1718,2017,2018,168,9573000,174,8566000,-6,1007000,Fulton County,Fulton County-Hamilton County-TN
2262,Fulton County-Greenville County-SC-1718,"Greenville County, SC",1718,2017,2018,180,8312000,192,11428000,-12,-3116000,Fulton County,Fulton County-Greenville County-SC
2263,Fulton County-Allegheny County-PA-1718,"Allegheny County, PA",1718,2017,2018,175,6410000,135,9126000,40,-2716000,Fulton County,Fulton County-Allegheny County-PA
2264,Fulton County-Oakland County-MI-1718,"Oakland County, MI",1718,2017,2018,180,12091000,114,5955000,66,6136000,Fulton County,Fulton County-Oakland County-MI
2265,Fulton County-Bronx County-NY-1718,"Bronx County, NY",1718,2017,2018,175,4033000,77,1704000,98,2329000,Fulton County,Fulton County-Bronx County-NY
2266,Fulton County-Clark County-NV-1718,"Clark County, NV",1718,2017,2018,188,6112000,184,6687000,4,-575000,Fulton County,Fulton County-Clark County-NV
2267,Fulton County-San Francisco County-CA-1718,"San Francisco County, CA",1718,2017,2018,139,15329000,194,16100000,-55,-771000,Fulton County,Fulton County-San Francisco County-CA
2268,Fulton County-Montgomery County-AL-1718,"Montgomery County, AL",1718,2017,2018,170,5323000,71,1682000,99,3641000,Fulton County,Fulton County-Montgomery County-AL
2269,Fulton County-Franklin County-OH-1718,"Franklin County, OH",1718,2017,2018,156,5080000,121,4107000,35,973000,Fulton County,Fulton County-Franklin County-OH
2270,Fulton County-Knox County-TN-1718,"Knox County, TN",1718,2017,2018,138,7192000,101,5829000,37,1363000,Fulton County,Fulton County-Knox County-TN
2271,Fulton County-Tarrant County-TX-1718,"Tarrant County, TX",1718,2017,2018,176,9293000,174,7666000,2,1627000,Fulton County,Fulton County-Tarrant County-TX
2272,Fulton County-Jefferson County-KY-1718,"Jefferson County, KY",1718,2017,2018,157,11159000,85,3786000,72,7373000,Fulton County,Fulton County-Jefferson County-KY
2273,Fulton County-Middlesex County-NJ-1718,"Middlesex County, NJ",1718,2017,2018,196,11584000,95,3830000,101,7754000,Fulton County,Fulton County-Middlesex County-NJ
2274,Fulton County-Houston County-GA-1718,"Houston County, GA",1718,2017,2018,150,5248000,102,2625000,48,2623000,Fulton County,Fulton County-Houston County-GA
2275,Fulton County-Nassau County-NY-1718,"Nassau County, NY",1718,2017,2018,161,9301000,59,3404000,102,5897000,Fulton County,Fulton County-Nassau County-NY
2276,Fulton County-Suffolk County-NY-1718,"Suffolk County, NY",1718,2017,2018,160,7539000,52,2133000,108,5406000,Fulton County,Fulton County-Suffolk County-NY
2277,Fulton County-Madison County-AL-1718,"Madison County, AL",1718,2017,2018,146,6020000,81,3270000,65,2750000,Fulton County,Fulton County-Madison County-AL
2278,Fulton County-Lee County-AL-1718,"Lee County, AL",1718,2017,2018,121,5436000,91,2729000,30,2707000,Fulton County,Fulton County-Lee County-AL
2279,Fulton County-St. Louis County-MO-1718,"St. Louis County, MO",1718,2017,2018,151,6385000,96,4253000,55,2132000,Fulton County,Fulton County-St. Louis County-MO
2280,Fulton County-Fairfield County-CT-1718,"Fairfield County, CT",1718,2017,2018,159,14057000,78,12927000,81,1130000,Fulton County,Fulton County-Fairfield County-CT
2281,Fulton County-Denver County-CO-1718,"Denver County, CO",1718,2017,2018,118,8834000,203,14559000,-85,-5725000,Fulton County,Fulton County-Denver County-CO
2282,Fulton County-Essex County-NJ-1718,"Essex County, NJ",1718,2017,2018,168,5278000,71,2063000,97,3215000,Fulton County,Fulton County-Essex County-NJ
2283,Fulton County-Hudson County-NJ-1718,"Hudson County, NJ",1718,2017,2018,137,13349000,122,6700000,15,6649000,Fulton County,Fulton County-Hudson County-NJ
2284,Fulton County-Westchester County-NY-1718,"Westchester County, NY",1718,2017,2018,167,9591000,71,4152000,96,5439000,Fulton County,Fulton County-Westchester County-NY
2285,Fulton County-Milwaukee County-WI-1718,"Milwaukee County, WI",1718,2017,2018,129,4511000,67,3505000,62,1006000,Fulton County,Fulton County-Milwaukee County-WI
2286,Fulton County-Bergen County-NJ-1718,"Bergen County, NJ",1718,2017,2018,152,7729000,71,4124000,81,3605000,Fulton County,Fulton County-Bergen County-NJ
2287,Fulton County-Hamilton County-OH-1718,"Hamilton County, OH",1718,2017,2018,135,5361000,91,4494000,44,867000,Fulton County,Fulton County-Hamilton County-OH
2288,Fulton County-Orleans Parish-LA-1718,"Orleans Parish, LA",1718,2017,2018,117,3944000,136,3852000,-19,92000,Fulton County,Fulton County-Orleans Parish-LA
2289,Fulton County-Baltimore County-MD-1718,"Baltimore County, MD",1718,2017,2018,139,6917000,75,1538000,64,5379000,Fulton County,Fulton County-Baltimore County-MD
2290,Fulton County-Baltimore city-MD-1718,"Baltimore city, MD",1718,2017,2018,116,4644000,92,4125000,24,519000,Fulton County,Fulton County-Baltimore city-MD
2291,Fulton County-Bexar County-TX-1718,"Bexar County, TX",1718,2017,2018,133,4359000,102,3728000,31,631000,Fulton County,Fulton County-Bexar County-TX
2292,Fulton County-Columbia County-GA-1718,"Columbia County, GA",1718,2017,2018,120,6128000,73,3365000,47,2763000,Fulton County,Fulton County-Columbia County-GA
2293,Fulton County-Seminole County-FL-1718,"Seminole County, FL",1718,2017,2018,132,4996000,109,6922000,23,-1926000,Fulton County,Fulton County-Seminole County-FL
2294,Fulton County-Shelby County-AL-1718,"Shelby County, AL",1718,2017,2018,117,4674000,58,2474000,59,2200000,Fulton County,Fulton County-Shelby County-AL
2295,Fulton County-Troup County-GA-1718,"Troup County, GA",1718,2017,2018,144,4557000,75,1398000,69,3159000,Fulton County,Fulton County-Troup County-GA
2296,Fulton County-Spalding County-GA-1718,"Spalding County, GA",1718,2017,2018,128,3441000,191,3604000,-63,-163000,Fulton County,Fulton County-Spalding County-GA
2297,Fulton County-Lee County-FL-1718,"Lee County, FL",1718,2017,2018,113,4366000,87,8022000,26,-3656000,Fulton County,Fulton County-Lee County-FL
2298,Fulton County-Dougherty County-GA-1718,"Dougherty County, GA",1718,2017,2018,117,2528000,95,1764000,22,764000,Fulton County,Fulton County-Dougherty County-GA
2299,Fulton County-Glynn County-GA-1718,"Glynn County, GA",1718,2017,2018,100,3078000,104,4624000,-4,-1546000,Fulton County,Fulton County-Glynn County-GA
2300,Fulton County-Arlington County-VA-1718,"Arlington County, VA",1718,2017,2018,104,7570000,70,4445000,34,3125000,Fulton County,Fulton County-Arlington County-VA
2301,Fulton County-Walton County-GA-1718,"Walton County, GA",1718,2017,2018,117,3276000,119,3049000,-2,227000,Fulton County,Fulton County-Walton County-GA
2302,Fulton County-Hartford County-CT-1718,"Hartford County, CT",1718,2017,2018,127,7235000,55,2458000,72,4777000,Fulton County,Fulton County-Hartford County-CT
2303,Fulton County-Marion County-IN-1718,"Marion County, IN",1718,2017,2018,116,3108000,89,3797000,27,-689000,Fulton County,Fulton County-Marion County-IN
2304,Fulton County-Durham County-NC-1718,"Durham County, NC",1718,2017,2018,79,4175000,115,5997000,-36,-1822000,Fulton County,Fulton County-Durham County-NC
2305,Fulton County-Virginia Beach city-VA-1718,"Virginia Beach city, VA",1718,2017,2018,117,4587000,40,1144000,77,3443000,Fulton County,Fulton County-Virginia Beach city-VA
2306,Fulton County-Bartow County-GA-1718,"Bartow County, GA",1718,2017,2018,110,3401000,140,4034000,-30,-633000,Fulton County,Fulton County-Bartow County-GA
2307,Fulton County-DuPage County-IL-1718,"DuPage County, IL",1718,2017,2018,147,9883000,93,4813000,54,5070000,Fulton County,Fulton County-DuPage County-IL
2308,Fulton County-Floyd County-GA-1718,"Floyd County, GA",1718,2017,2018,88,3126000,86,2633000,2,493000,Fulton County,Fulton County-Floyd County-GA
2309,Fulton County-Mobile County-AL-1718,"Mobile County, AL",1718,2017,2018,105,2988000,70,2037000,35,951000,Fulton County,Fulton County-Mobile County-AL
2310,Fulton County-Tuscaloosa County-AL-1718,"Tuscaloosa County, AL",1718,2017,2018,90,2845000,38,1436000,52,1409000,Fulton County,Fulton County-Tuscaloosa County-AL
2311,Fulton County-Contra Costa County-CA-1718,"Contra Costa County, CA",1718,2017,2018,118,10859000,82,6526000,36,4333000,Fulton County,Fulton County-Contra Costa County-CA
2312,Fulton County-Lowndes County-GA-1718,"Lowndes County, GA",1718,2017,2018,88,2255000,67,1377000,21,878000,Fulton County,Fulton County-Lowndes County-GA
2313,Fulton County-New Haven County-CT-1718,"New Haven County, CT",1718,2017,2018,87,2647000,42,1170000,45,1477000,Fulton County,Fulton County-New Haven County-CT
2314,Fulton County-Escambia County-FL-1718,"Escambia County, FL",1718,2017,2018,103,2907000,64,4263000,39,-1356000,Fulton County,Fulton County-Escambia County-FL
2315,Fulton County-Brevard County-FL-1718,"Brevard County, FL",1718,2017,2018,93,2997000,98,5211000,-5,-2214000,Fulton County,Fulton County-Brevard County-FL
2316,Fulton County-Sarasota County-FL-1718,"Sarasota County, FL",1718,2017,2018,85,3690000,94,10318000,-9,-6628000,Fulton County,Fulton County-Sarasota County-FL
2317,Fulton County-Jefferson Parish-LA-1718,"Jefferson Parish, LA",1718,2017,2018,107,2360000,44,1129000,63,1231000,Fulton County,Fulton County-Jefferson Parish-LA
2318,Fulton County-Anne Arundel County-MD-1718,"Anne Arundel County, MD",1718,2017,2018,90,4219000,55,1929000,35,2290000,Fulton County,Fulton County-Anne Arundel County-MD
2319,Fulton County-Denton County-TX-1718,"Denton County, TX",1718,2017,2018,95,4992000,101,6765000,-6,-1773000,Fulton County,Fulton County-Denton County-TX
2320,Fulton County-Hinds County-MS-1718,"Hinds County, MS",1718,2017,2018,87,2284000,44,957000,43,1327000,Fulton County,Fulton County-Hinds County-MS
2321,Fulton County-Monroe County-NY-1718,"Monroe County, NY",1718,2017,2018,85,3374000,75,2480000,10,894000,Fulton County,Fulton County-Monroe County-NY
2322,Fulton County-Forsyth County-NC-1718,"Forsyth County, NC",1718,2017,2018,87,3523000,51,3554000,36,-31000,Fulton County,Fulton County-Forsyth County-NC
2323,Fulton County-Volusia County-FL-1718,"Volusia County, FL",1718,2017,2018,79,2851000,67,3299000,12,-448000,Fulton County,Fulton County-Volusia County-FL
2324,Fulton County-St. Louis city-MO-1718,"St. Louis city, MO",1718,2017,2018,81,3821000,40,2035000,41,1786000,Fulton County,Fulton County-St. Louis city-MO
2325,Fulton County-St. Johns County-FL-1718,"St. Johns County, FL",1718,2017,2018,80,12102000,125,9030000,-45,3072000,Fulton County,Fulton County-St. Johns County-FL
2326,Fulton County-Lake County-IL-1718,"Lake County, IL",1718,2017,2018,96,5026000,47,3630000,49,1396000,Fulton County,Fulton County-Lake County-IL
2327,Fulton County-Norfolk County-MA-1718,"Norfolk County, MA",1718,2017,2018,88,3595000,60,3616000,28,-21000,Fulton County,Fulton County-Norfolk County-MA
2328,Fulton County-Henrico County-VA-1718,"Henrico County, VA",1718,2017,2018,101,5229000,65,3122000,36,2107000,Fulton County,Fulton County-Henrico County-VA
2329,Fulton County-Loudoun County-VA-1718,"Loudoun County, VA",1718,2017,2018,98,5315000,75,3582000,23,1733000,Fulton County,Fulton County-Loudoun County-VA
2330,Fulton County-Will County-IL-1718,"Will County, IL",1718,2017,2018,107,4925000,33,819000,74,4106000,Fulton County,Fulton County-Will County-IL
2331,Fulton County-Buncombe County-NC-1718,"Buncombe County, NC",1718,2017,2018,71,4781000,76,4632000,-5,149000,Fulton County,Fulton County-Buncombe County-NC
2332,Fulton County-Dane County-WI-1718,"Dane County, WI",1718,2017,2018,67,2685000,28,990000,39,1695000,Fulton County,Fulton County-Dane County-WI
2333,Fulton County-Beaufort County-SC-1718,"Beaufort County, SC",1718,2017,2018,80,4099000,134,15724000,-54,-11625000,Fulton County,Fulton County-Beaufort County-SC
2334,Fulton County-Alexandria city-VA-1718,"Alexandria city, VA",1718,2017,2018,65,5084000,73,8500000,-8,-3416000,Fulton County,Fulton County-Alexandria city-VA
2335,Fulton County-Riverside County-CA-1718,"Riverside County, CA",1718,2017,2018,85,2906000,76,3560000,9,-654000,Fulton County,Fulton County-Riverside County-CA
2336,Fulton County-Bay County-FL-1718,"Bay County, FL",1718,2017,2018,71,3660000,54,2995000,17,665000,Fulton County,Fulton County-Bay County-FL
2337,Fulton County-Cumberland County-NC-1718,"Cumberland County, NC",1718,2017,2018,74,1863000,65,1113000,9,750000,Fulton County,Fulton County-Cumberland County-NC
2338,Fulton County-Richmond city-VA-1718,"Richmond city, VA",1718,2017,2018,56,3035000,54,3002000,2,33000,Fulton County,Fulton County-Richmond city-VA
2339,Fulton County-Bulloch County-GA-1718,"Bulloch County, GA",1718,2017,2018,57,1018000,37,812000,20,206000,Fulton County,Fulton County-Bulloch County-GA
2340,Fulton County-Jackson County-GA-1718,"Jackson County, GA",1718,2017,2018,77,2371000,88,3830000,-11,-1459000,Fulton County,Fulton County-Jackson County-GA
2341,Fulton County-Douglas County-NE-1718,"Douglas County, NE",1718,2017,2018,78,3503000,39,1115000,39,2388000,Fulton County,Fulton County-Douglas County-NE
2342,Fulton County-Erie County-NY-1718,"Erie County, NY",1718,2017,2018,69,2389000,51,2270000,18,119000,Fulton County,Fulton County-Erie County-NY
2343,Fulton County-Polk County-FL-1718,"Polk County, FL",1718,2017,2018,73,1774000,74,2680000,-1,-906000,Fulton County,Fulton County-Polk County-FL
2344,Fulton County-Salt Lake County-UT-1718,"Salt Lake County, UT",1718,2017,2018,68,3340000,85,3603000,-17,-263000,Fulton County,Fulton County-Salt Lake County-UT
2345,Fulton County-New Castle County-DE-1718,"New Castle County, DE",1718,2017,2018,70,2192000,53,1675000,17,517000,Fulton County,Fulton County-New Castle County-DE
2346,Fulton County-Barrow County-GA-1718,"Barrow County, GA",1718,2017,2018,54,1757000,91,2221000,-37,-464000,Fulton County,Fulton County-Barrow County-GA
2347,Fulton County-Morris County-NJ-1718,"Morris County, NJ",1718,2017,2018,71,5009000,42,2934000,29,2075000,Fulton County,Fulton County-Morris County-NJ
2348,Fulton County-Fort Bend County-TX-1718,"Fort Bend County, TX",1718,2017,2018,73,3515000,82,5092000,-9,-1577000,Fulton County,Fulton County-Fort Bend County-TX
2349,Fulton County-Arapahoe County-CO-1718,"Arapahoe County, CO",1718,2017,2018,63,2099000,78,5492000,-15,-3393000,Fulton County,Fulton County-Arapahoe County-CO
2350,Fulton County-Honolulu County-HI-1718,"Honolulu County, HI",1718,2017,2018,82,2515000,63,1621000,19,894000,Fulton County,Fulton County-Honolulu County-HI
2351,Fulton County-Multnomah County-OR-1718,"Multnomah County, OR",1718,2017,2018,54,2415000,117,6255000,-63,-3840000,Fulton County,Fulton County-Multnomah County-OR
2352,Fulton County-Montgomery County-PA-1718,"Montgomery County, PA",1718,2017,2018,83,3350000,81,5935000,2,-2585000,Fulton County,Fulton County-Montgomery County-PA
2353,Fulton County-Williamson County-TN-1718,"Williamson County, TN",1718,2017,2018,97,5531000,99,6544000,-2,-1013000,Fulton County,Fulton County-Williamson County-TN
2354,Fulton County-San Bernardino County-CA-1718,"San Bernardino County, CA",1718,2017,2018,69,1634000,67,1391000,2,243000,Fulton County,Fulton County-San Bernardino County-CA
2355,Fulton County-Washtenaw County-MI-1718,"Washtenaw County, MI",1718,2017,2018,64,2119000,58,3510000,6,-1391000,Fulton County,Fulton County-Washtenaw County-MI
2356,Fulton County-St. Lucie County-FL-1718,"St. Lucie County, FL",1718,2017,2018,64,1914000,60,3632000,4,-1718000,Fulton County,Fulton County-St. Lucie County-FL
2357,Fulton County-Collier County-FL-1718,"Collier County, FL",1718,2017,2018,57,4231000,62,10023000,-5,-5792000,Fulton County,Fulton County-Collier County-FL
2358,Fulton County-Manatee County-FL-1718,"Manatee County, FL",1718,2017,2018,55,2269000,122,13255000,-67,-10986000,Fulton County,Fulton County-Manatee County-FL
2359,Fulton County-Osceola County-FL-1718,"Osceola County, FL",1718,2017,2018,63,1379000,44,1339000,19,40000,Fulton County,Fulton County-Osceola County-FL
2360,Fulton County-Baldwin County-GA-1718,"Baldwin County, GA",1718,2017,2018,42,1498000,36,1239000,6,259000,Fulton County,Fulton County-Baldwin County-GA
2361,Fulton County-Oconee County-GA-1718,"Oconee County, GA",1718,2017,2018,59,4293000,49,2826000,10,1467000,Fulton County,Fulton County-Oconee County-GA
2362,Fulton County-Fayette County-KY-1718,"Fayette County, KY",1718,2017,2018,65,2988000,43,1975000,22,1013000,Fulton County,Fulton County-Fayette County-KY
2363,Fulton County-Jackson County-MO-1718,"Jackson County, MO",1718,2017,2018,60,1982000,32,1386000,28,596000,Fulton County,Fulton County-Jackson County-MO
2364,Fulton County-Chester County-PA-1718,"Chester County, PA",1718,2017,2018,65,3204000,43,3070000,22,134000,Fulton County,Fulton County-Chester County-PA
2365,Fulton County-Rutherford County-TN-1718,"Rutherford County, TN",1718,2017,2018,56,2082000,49,1539000,7,543000,Fulton County,Fulton County-Rutherford County-TN
2366,Fulton County-Pulaski County-AR-1718,"Pulaski County, AR",1718,2017,2018,56,2106000,35,1211000,21,895000,Fulton County,Fulton County-Pulaski County-AR
2367,Fulton County-Sacramento County-CA-1718,"Sacramento County, CA",1718,2017,2018,49,1746000,86,3220000,-37,-1474000,Fulton County,Fulton County-Sacramento County-CA
2368,Fulton County-Pasco County-FL-1718,"Pasco County, FL",1718,2017,2018,45,1310000,49,1941000,-4,-631000,Fulton County,Fulton County-Pasco County-FL
2369,Fulton County-Oklahoma County-OK-1718,"Oklahoma County, OK",1718,2017,2018,68,2185000,37,2101000,31,84000,Fulton County,Fulton County-Oklahoma County-OK
2370,Fulton County-Berkeley County-SC-1718,"Berkeley County, SC",1718,2017,2018,59,2435000,73,4287000,-14,-1852000,Fulton County,Fulton County-Berkeley County-SC
2371,Fulton County-Lexington County-SC-1718,"Lexington County, SC",1718,2017,2018,46,1743000,46,1257000,0,486000,Fulton County,Fulton County-Lexington County-SC
2372,Fulton County-Lumpkin County-GA-1718,"Lumpkin County, GA",1718,2017,2018,46,1469000,78,6344000,-32,-4875000,Fulton County,Fulton County-Lumpkin County-GA
2373,Fulton County-Howard County-MD-1718,"Howard County, MD",1718,2017,2018,48,2527000,52,1931000,-4,596000,Fulton County,Fulton County-Howard County-MD
2374,Fulton County-Essex County-MA-1718,"Essex County, MA",1718,2017,2018,57,2772000,56,3182000,1,-410000,Fulton County,Fulton County-Essex County-MA
2375,Fulton County-San Mateo County-CA-1718,"San Mateo County, CA",1718,2017,2018,51,3364000,101,8015000,-50,-4651000,Fulton County,Fulton County-San Mateo County-CA
2376,Fulton County-Mercer County-NJ-1718,"Mercer County, NJ",1718,2017,2018,63,2103000,36,1137000,27,966000,Fulton County,Fulton County-Mercer County-NJ
2377,Fulton County-New Hanover County-NC-1718,"New Hanover County, NC",1718,2017,2018,36,1337000,36,4063000,0,-2726000,Fulton County,Fulton County-New Hanover County-NC
2378,Fulton County-Delaware County-PA-1718,"Delaware County, PA",1718,2017,2018,42,1834000,48,1600000,-6,234000,Fulton County,Fulton County-Delaware County-PA
2379,Fulton County-Snohomish County-WA-1718,"Snohomish County, WA",1718,2017,2018,68,2498000,37,1465000,31,1033000,Fulton County,Fulton County-Snohomish County-WA
2380,Fulton County-Okaloosa County-FL-1718,"Okaloosa County, FL",1718,2017,2018,45,1433000,72,3308000,-27,-1875000,Fulton County,Fulton County-Okaloosa County-FL
2381,Fulton County-Walton County-FL-1718,"Walton County, FL",1718,2017,2018,55,10443000,134,31027000,-79,-20584000,Fulton County,Fulton County-Walton County-FL
2382,Fulton County-Dawson County-GA-1718,"Dawson County, GA",1718,2017,2018,38,2503000,120,7057000,-82,-4554000,Fulton County,Fulton County-Dawson County-GA
2383,Fulton County-Meriwether County-GA-1718,"Meriwether County, GA",1718,2017,2018,54,968000,47,972000,7,-4000,Fulton County,Fulton County-Meriwether County-GA
2384,Fulton County-Johnson County-KS-1718,"Johnson County, KS",1718,2017,2018,60,3235000,41,3423000,19,-188000,Fulton County,Fulton County-Johnson County-KS
2385,Fulton County-Worcester County-MA-1718,"Worcester County, MA",1718,2017,2018,56,3158000,31,1237000,25,1921000,Fulton County,Fulton County-Worcester County-MA
2386,Fulton County-Prince William County-VA-1718,"Prince William County, VA",1718,2017,2018,46,2145000,65,2362000,-19,-217000,Fulton County,Fulton County-Prince William County-VA
2387,Fulton County-Pima County-AZ-1718,"Pima County, AZ",1718,2017,2018,34,2120000,37,3378000,-3,-1258000,Fulton County,Fulton County-Pima County-AZ
2388,Fulton County-Pickens County-GA-1718,"Pickens County, GA",1718,2017,2018,42,3886000,119,12261000,-77,-8375000,Fulton County,Fulton County-Pickens County-GA
2389,Fulton County-Lake County-FL-1718,"Lake County, FL",1718,2017,2018,42,1503000,49,1956000,-7,-453000,Fulton County,Fulton County-Lake County-FL
2390,Fulton County-Washington County-OR-1718,"Washington County, OR",1718,2017,2018,52,1977000,45,2575000,7,-598000,Fulton County,Fulton County-Washington County-OR
2391,Fulton County-El Paso County-CO-1718,"El Paso County, CO",1718,2017,2018,39,1115000,54,1671000,-15,-556000,Fulton County,Fulton County-El Paso County-CO
2392,Fulton County-Ramsey County-MN-1718,"Ramsey County, MN",1718,2017,2018,36,2156000,42,1640000,-6,516000,Fulton County,Fulton County-Ramsey County-MN
2393,Fulton County-Monmouth County-NJ-1718,"Monmouth County, NJ",1718,2017,2018,38,1189000,40,2151000,-2,-962000,Fulton County,Fulton County-Monmouth County-NJ
2394,Fulton County-Bell County-TX-1718,"Bell County, TX",1718,2017,2018,46,838000,46,792000,0,46000,Fulton County,Fulton County-Bell County-TX
2395,Fulton County-Pierce County-WA-1718,"Pierce County, WA",1718,2017,2018,52,1722000,34,1437000,18,285000,Fulton County,Fulton County-Pierce County-WA
2396,Fulton County-Norfolk city-VA-1718,"Norfolk city, VA",1718,2017,2018,36,1236000,49,492000,-13,744000,Fulton County,Fulton County-Norfolk city-VA
2397,Fulton County-Baldwin County-AL-1718,"Baldwin County, AL",1718,2017,2018,37,2283000,47,2321000,-10,-38000,Fulton County,Fulton County-Baldwin County-AL
2398,Fulton County-Boulder County-CO-1718,"Boulder County, CO",1718,2017,2018,26,1300000,40,2966000,-14,-1666000,Fulton County,Fulton County-Boulder County-CO
2399,Fulton County-Bernalillo County-NM-1718,"Bernalillo County, NM",1718,2017,2018,40,1042000,41,1547000,-1,-505000,Fulton County,Fulton County-Bernalillo County-NM
2400,Fulton County-Dorchester County-SC-1718,"Dorchester County, SC",1718,2017,2018,28,888000,38,1337000,-10,-449000,Fulton County,Fulton County-Dorchester County-SC
2401,Fulton County-York County-SC-1718,"York County, SC",1718,2017,2018,27,1007000,45,2332000,-18,-1325000,Fulton County,Fulton County-York County-SC
2402,Fulton County-Montgomery County-TN-1718,"Montgomery County, TN",1718,2017,2018,33,792000,70,1299000,-37,-507000,Fulton County,Fulton County-Montgomery County-TN
2404,Gwinnett County-DeKalb County-GA-1718,"DeKalb County, GA",1718,2017,2018,12024,256430000,8214,196222000,3810,60208000,Gwinnett County,Gwinnett County-DeKalb County-GA
2405,Gwinnett County-Fulton County-GA-1718,"Fulton County, GA",1718,2017,2018,6151,226372000,6041,216365000,110,10007000,Gwinnett County,Gwinnett County-Fulton County-GA
2406,Gwinnett County-Cobb County-GA-1718,"Cobb County, GA",1718,2017,2018,2255,99112000,2422,76200000,-167,22912000,Gwinnett County,Gwinnett County-Cobb County-GA
2407,Gwinnett County-Hall County-GA-1718,"Hall County, GA",1718,2017,2018,1781,50233000,3047,109712000,-1266,-59479000,Gwinnett County,Gwinnett County-Hall County-GA
2408,Gwinnett County-Forsyth County-GA-1718,"Forsyth County, GA",1718,2017,2018,1417,49271000,2415,102375000,-998,-53104000,Gwinnett County,Gwinnett County-Forsyth County-GA
2409,Gwinnett County-Barrow County-GA-1718,"Barrow County, GA",1718,2017,2018,1195,26404000,2906,67634000,-1711,-41230000,Gwinnett County,Gwinnett County-Barrow County-GA
2410,Gwinnett County-Walton County-GA-1718,"Walton County, GA",1718,2017,2018,1212,27944000,2727,73289000,-1515,-45345000,Gwinnett County,Gwinnett County-Walton County-GA
2411,Gwinnett County-Clayton County-GA-1718,"Clayton County, GA",1718,2017,2018,997,16013000,912,13039000,85,2974000,Gwinnett County,Gwinnett County-Clayton County-GA
2412,Gwinnett County-Miami-Dade County-FL-1718,"Miami-Dade County, FL",1718,2017,2018,653,12206000,246,4481000,407,7725000,Gwinnett County,Gwinnett County-Miami-Dade County-FL
2413,Gwinnett County-Broward County-FL-1718,"Broward County, FL",1718,2017,2018,604,12024000,324,7079000,280,4945000,Gwinnett County,Gwinnett County-Broward County-FL
2414,Gwinnett County-Henry County-GA-1718,"Henry County, GA",1718,2017,2018,581,15762000,582,14065000,-1,1697000,Gwinnett County,Gwinnett County-Henry County-GA
2415,Gwinnett County-Rockdale County-GA-1718,"Rockdale County, GA",1718,2017,2018,578,12589000,701,13500000,-123,-911000,Gwinnett County,Gwinnett County-Rockdale County-GA
2416,Gwinnett County-Los Angeles County-CA-1718,"Los Angeles County, CA",1718,2017,2018,505,10943000,248,8732000,257,2211000,Gwinnett County,Gwinnett County-Los Angeles County-CA
2417,Gwinnett County-Clarke County-GA-1718,"Clarke County, GA",1718,2017,2018,391,8649000,399,11988000,-8,-3339000,Gwinnett County,Gwinnett County-Clarke County-GA
2418,Gwinnett County-Jackson County-GA-1718,"Jackson County, GA",1718,2017,2018,530,14836000,1641,53223000,-1111,-38387000,Gwinnett County,Gwinnett County-Jackson County-GA
2419,Gwinnett County-Queens County-NY-1718,"Queens County, NY",1718,2017,2018,478,9175000,172,2581000,306,6594000,Gwinnett County,Gwinnett County-Queens County-NY
2420,Gwinnett County-Newton County-GA-1718,"Newton County, GA",1718,2017,2018,446,9062000,657,13002000,-211,-3940000,Gwinnett County,Gwinnett County-Newton County-GA
2421,Gwinnett County-Cherokee County-GA-1718,"Cherokee County, GA",1718,2017,2018,397,10440000,709,24520000,-312,-14080000,Gwinnett County,Gwinnett County-Cherokee County-GA
2422,Gwinnett County-Cook County-IL-1718,"Cook County, IL",1718,2017,2018,430,9168000,176,4072000,254,5096000,Gwinnett County,Gwinnett County-Cook County-IL
2423,Gwinnett County-Douglas County-GA-1718,"Douglas County, GA",1718,2017,2018,362,7384000,292,5881000,70,1503000,Gwinnett County,Gwinnett County-Douglas County-GA
2424,Gwinnett County-Kings County-NY-1718,"Kings County, NY",1718,2017,2018,411,7297000,152,2486000,259,4811000,Gwinnett County,Gwinnett County-Kings County-NY
2425,Gwinnett County-Orange County-FL-1718,"Orange County, FL",1718,2017,2018,332,7395000,316,9100000,16,-1705000,Gwinnett County,Gwinnett County-Orange County-FL
2426,Gwinnett County-Hillsborough County-FL-1718,"Hillsborough County, FL",1718,2017,2018,324,6780000,228,5913000,96,867000,Gwinnett County,Gwinnett County-Hillsborough County-FL
2427,Gwinnett County-Chatham County-GA-1718,"Chatham County, GA",1718,2017,2018,253,5919000,210,4999000,43,920000,Gwinnett County,Gwinnett County-Chatham County-GA
2428,Gwinnett County-Palm Beach County-FL-1718,"Palm Beach County, FL",1718,2017,2018,295,8452000,174,4276000,121,4176000,Gwinnett County,Gwinnett County-Palm Beach County-FL
2429,Gwinnett County-Mecklenburg County-NC-1718,"Mecklenburg County, NC",1718,2017,2018,233,6782000,220,6052000,13,730000,Gwinnett County,Gwinnett County-Mecklenburg County-NC
2430,Gwinnett County-Harris County-TX-1718,"Harris County, TX",1718,2017,2018,312,6021000,287,7502000,25,-1481000,Gwinnett County,Gwinnett County-Harris County-TX
2431,Gwinnett County-Duval County-FL-1718,"Duval County, FL",1718,2017,2018,246,6202000,227,5715000,19,487000,Gwinnett County,Gwinnett County-Duval County-FL
2432,Gwinnett County-Bronx County-NY-1718,"Bronx County, NY",1718,2017,2018,261,5270000,90,1158000,171,4112000,Gwinnett County,Gwinnett County-Bronx County-NY
2433,Gwinnett County-Orange County-CA-1718,"Orange County, CA",1718,2017,2018,252,10279000,111,4036000,141,6243000,Gwinnett County,Gwinnett County-Orange County-CA
2434,Gwinnett County-New York County-NY-1718,"New York County, NY",1718,2017,2018,208,5076000,85,3641000,123,1435000,Gwinnett County,Gwinnett County-New York County-NY
2435,Gwinnett County-Nassau County-NY-1718,"Nassau County, NY",1718,2017,2018,223,4531000,33,855000,190,3676000,Gwinnett County,Gwinnett County-Nassau County-NY
2436,Gwinnett County-Suffolk County-NY-1718,"Suffolk County, NY",1718,2017,2018,204,3637000,46,964000,158,2673000,Gwinnett County,Gwinnett County-Suffolk County-NY
2437,Gwinnett County-Muscogee County-GA-1718,"Muscogee County, GA",1718,2017,2018,183,3212000,131,2216000,52,996000,Gwinnett County,Gwinnett County-Muscogee County-GA
2438,Gwinnett County-Dallas County-TX-1718,"Dallas County, TX",1718,2017,2018,166,4078000,162,4641000,4,-563000,Gwinnett County,Gwinnett County-Dallas County-TX
2439,Gwinnett County-Maricopa County-AZ-1718,"Maricopa County, AZ",1718,2017,2018,187,8583000,216,6847000,-29,1736000,Gwinnett County,Gwinnett County-Maricopa County-AZ
2440,Gwinnett County-Fayette County-GA-1718,"Fayette County, GA",1718,2017,2018,158,4526000,145,5216000,13,-690000,Gwinnett County,Gwinnett County-Fayette County-GA
2441,Gwinnett County-Shelby County-TN-1718,"Shelby County, TN",1718,2017,2018,175,3165000,84,2020000,91,1145000,Gwinnett County,Gwinnett County-Shelby County-TN
2442,Gwinnett County-Richmond County-GA-1718,"Richmond County, GA",1718,2017,2018,135,2323000,149,2937000,-14,-614000,Gwinnett County,Gwinnett County-Richmond County-GA
2443,Gwinnett County-Paulding County-GA-1718,"Paulding County, GA",1718,2017,2018,163,3291000,282,5784000,-119,-2493000,Gwinnett County,Gwinnett County-Paulding County-GA
2444,Gwinnett County-Clark County-NV-1718,"Clark County, NV",1718,2017,2018,164,3367000,157,4011000,7,-644000,Gwinnett County,Gwinnett County-Clark County-NV
2445,Gwinnett County-Bergen County-NJ-1718,"Bergen County, NJ",1718,2017,2018,174,4682000,36,903000,138,3779000,Gwinnett County,Gwinnett County-Bergen County-NJ
2446,Gwinnett County-Jefferson County-AL-1718,"Jefferson County, AL",1718,2017,2018,121,3354000,116,2931000,5,423000,Gwinnett County,Gwinnett County-Jefferson County-AL
2447,Gwinnett County-Bibb County-GA-1718,"Bibb County, GA",1718,2017,2018,149,3084000,144,3000000,5,84000,Gwinnett County,Gwinnett County-Bibb County-GA
2448,Gwinnett County-Wake County-NC-1718,"Wake County, NC",1718,2017,2018,154,4233000,170,5251000,-16,-1018000,Gwinnett County,Gwinnett County-Wake County-NC
2449,Gwinnett County-Pinellas County-FL-1718,"Pinellas County, FL",1718,2017,2018,140,2900000,152,4227000,-12,-1327000,Gwinnett County,Gwinnett County-Pinellas County-FL
2450,Gwinnett County-Davidson County-TN-1718,"Davidson County, TN",1718,2017,2018,147,3810000,111,3675000,36,135000,Gwinnett County,Gwinnett County-Davidson County-TN
2451,Gwinnett County-Prince George's County-MD-1718,"Prince George's County, MD",1718,2017,2018,142,2869000,116,1771000,26,1098000,Gwinnett County,Gwinnett County-Prince George's County-MD
2452,Gwinnett County-Houston County-GA-1718,"Houston County, GA",1718,2017,2018,129,3039000,105,2612000,24,427000,Gwinnett County,Gwinnett County-Houston County-GA
2453,Gwinnett County-Fairfax County-VA-1718,"Fairfax County, VA",1718,2017,2018,142,4951000,78,3215000,64,1736000,Gwinnett County,Gwinnett County-Fairfax County-VA
2454,Gwinnett County-Coweta County-GA-1718,"Coweta County, GA",1718,2017,2018,144,4116000,183,6038000,-39,-1922000,Gwinnett County,Gwinnett County-Coweta County-GA
2455,Gwinnett County-Franklin County-OH-1718,"Franklin County, OH",1718,2017,2018,136,2493000,86,2088000,50,405000,Gwinnett County,Gwinnett County-Franklin County-OH
2456,Gwinnett County-San Diego County-CA-1718,"San Diego County, CA",1718,2017,2018,130,3523000,111,2878000,19,645000,Gwinnett County,Gwinnett County-San Diego County-CA
2457,Gwinnett County-Philadelphia County-PA-1718,"Philadelphia County, PA",1718,2017,2018,116,2085000,84,1846000,32,239000,Gwinnett County,Gwinnett County-Philadelphia County-PA
2458,Gwinnett County-Greenville County-SC-1718,"Greenville County, SC",1718,2017,2018,118,3910000,135,3623000,-17,287000,Gwinnett County,Gwinnett County-Greenville County-SC
2459,Gwinnett County-Lee County-FL-1718,"Lee County, FL",1718,2017,2018,128,1923000,105,3126000,23,-1203000,Gwinnett County,Gwinnett County-Lee County-FL
2460,Gwinnett County-Essex County-NJ-1718,"Essex County, NJ",1718,2017,2018,132,2209000,46,987000,86,1222000,Gwinnett County,Gwinnett County-Essex County-NJ
2461,Gwinnett County-Hamilton County-TN-1718,"Hamilton County, TN",1718,2017,2018,123,3149000,144,5297000,-21,-2148000,Gwinnett County,Gwinnett County-Hamilton County-TN
2462,Gwinnett County-Guilford County-NC-1718,"Guilford County, NC",1718,2017,2018,123,2208000,49,397000,74,1811000,Gwinnett County,Gwinnett County-Guilford County-NC
2463,Gwinnett County-Montgomery County-MD-1718,"Montgomery County, MD",1718,2017,2018,111,4042000,114,3970000,-3,72000,Gwinnett County,Gwinnett County-Montgomery County-MD
2464,Gwinnett County-Cuyahoga County-OH-1718,"Cuyahoga County, OH",1718,2017,2018,107,2439000,83,1950000,24,489000,Gwinnett County,Gwinnett County-Cuyahoga County-OH
2465,Gwinnett County-Travis County-TX-1718,"Travis County, TX",1718,2017,2018,105,2689000,75,3133000,30,-444000,Gwinnett County,Gwinnett County-Travis County-TX
2466,Gwinnett County-Seminole County-FL-1718,"Seminole County, FL",1718,2017,2018,122,3011000,92,2223000,30,788000,Gwinnett County,Gwinnett County-Seminole County-FL
2467,Gwinnett County-Columbia County-GA-1718,"Columbia County, GA",1718,2017,2018,138,3386000,126,2949000,12,437000,Gwinnett County,Gwinnett County-Columbia County-GA
2468,Gwinnett County-Carroll County-GA-1718,"Carroll County, GA",1718,2017,2018,113,1810000,124,2264000,-11,-454000,Gwinnett County,Gwinnett County-Carroll County-GA
2469,Gwinnett County-Montgomery County-AL-1718,"Montgomery County, AL",1718,2017,2018,102,3466000,67,927000,35,2539000,Gwinnett County,Gwinnett County-Montgomery County-AL
2470,Gwinnett County-Wayne County-MI-1718,"Wayne County, MI",1718,2017,2018,120,1735000,100,1162000,20,573000,Gwinnett County,Gwinnett County-Wayne County-MI
2471,Gwinnett County-Middlesex County-NJ-1718,"Middlesex County, NJ",1718,2017,2018,122,3112000,52,1178000,70,1934000,Gwinnett County,Gwinnett County-Middlesex County-NJ
2472,Gwinnett County-Tarrant County-TX-1718,"Tarrant County, TX",1718,2017,2018,98,2910000,133,3426000,-35,-516000,Gwinnett County,Gwinnett County-Tarrant County-TX
2473,Gwinnett County-Westchester County-NY-1718,"Westchester County, NY",1718,2017,2018,124,3354000,38,598000,86,2756000,Gwinnett County,Gwinnett County-Westchester County-NY
2474,Gwinnett County-St. Louis County-MO-1718,"St. Louis County, MO",1718,2017,2018,104,2368000,55,1712000,49,656000,Gwinnett County,Gwinnett County-St. Louis County-MO
2475,Gwinnett County-Collin County-TX-1718,"Collin County, TX",1718,2017,2018,112,3165000,101,3552000,11,-387000,Gwinnett County,Gwinnett County-Collin County-TX
2476,Gwinnett County-Santa Clara County-CA-1718,"Santa Clara County, CA",1718,2017,2018,118,3272000,70,2761000,48,511000,Gwinnett County,Gwinnett County-Santa Clara County-CA
2477,Gwinnett County-Fairfield County-CT-1718,"Fairfield County, CT",1718,2017,2018,85,2743000,43,1795000,42,948000,Gwinnett County,Gwinnett County-Fairfield County-CT
2478,Gwinnett County-Jefferson County-KY-1718,"Jefferson County, KY",1718,2017,2018,116,2983000,50,984000,66,1999000,Gwinnett County,Gwinnett County-Jefferson County-KY
2479,Gwinnett County-King County-WA-1718,"King County, WA",1718,2017,2018,92,2604000,150,6493000,-58,-3889000,Gwinnett County,Gwinnett County-King County-WA
2480,Gwinnett County-Charleston County-SC-1718,"Charleston County, SC",1718,2017,2018,96,2438000,81,3103000,15,-665000,Gwinnett County,Gwinnett County-Charleston County-SC
2481,Gwinnett County-Suffolk County-MA-1718,"Suffolk County, MA",1718,2017,2018,99,2769000,45,1374000,54,1395000,Gwinnett County,Gwinnett County-Suffolk County-MA
2482,Gwinnett County-Richland County-SC-1718,"Richland County, SC",1718,2017,2018,103,2070000,108,2216000,-5,-146000,Gwinnett County,Gwinnett County-Richland County-SC
2483,Gwinnett County-Madison County-AL-1718,"Madison County, AL",1718,2017,2018,95,1937000,98,2359000,-3,-422000,Gwinnett County,Gwinnett County-Madison County-AL
2484,Gwinnett County-Lee County-AL-1718,"Lee County, AL",1718,2017,2018,93,1767000,65,2286000,28,-519000,Gwinnett County,Gwinnett County-Lee County-AL
2485,Gwinnett County-Lowndes County-GA-1718,"Lowndes County, GA",1718,2017,2018,74,1772000,48,956000,26,816000,Gwinnett County,Gwinnett County-Lowndes County-GA
2486,Gwinnett County-Oakland County-MI-1718,"Oakland County, MI",1718,2017,2018,79,2073000,42,1059000,37,1014000,Gwinnett County,Gwinnett County-Oakland County-MI
2487,Gwinnett County-Alameda County-CA-1718,"Alameda County, CA",1718,2017,2018,77,2321000,54,2372000,23,-51000,Gwinnett County,Gwinnett County-Alameda County-CA
2488,Gwinnett County-Riverside County-CA-1718,"Riverside County, CA",1718,2017,2018,101,2444000,83,1565000,18,879000,Gwinnett County,Gwinnett County-Riverside County-CA
2489,Gwinnett County-Polk County-FL-1718,"Polk County, FL",1718,2017,2018,93,2082000,93,2537000,0,-455000,Gwinnett County,Gwinnett County-Polk County-FL
2490,Gwinnett County-Middlesex County-MA-1718,"Middlesex County, MA",1718,2017,2018,99,3211000,48,1613000,51,1598000,Gwinnett County,Gwinnett County-Middlesex County-MA
2491,Gwinnett County-Knox County-TN-1718,"Knox County, TN",1718,2017,2018,100,2222000,65,1849000,35,373000,Gwinnett County,Gwinnett County-Knox County-TN
2492,Gwinnett County-Brevard County-FL-1718,"Brevard County, FL",1718,2017,2018,79,2039000,104,4632000,-25,-2593000,Gwinnett County,Gwinnett County-Brevard County-FL
2493,Gwinnett County-Bartow County-GA-1718,"Bartow County, GA",1718,2017,2018,80,1669000,131,2563000,-51,-894000,Gwinnett County,Gwinnett County-Bartow County-GA
2494,Gwinnett County-Marion County-IN-1718,"Marion County, IN",1718,2017,2018,79,1461000,84,1356000,-5,105000,Gwinnett County,Gwinnett County-Marion County-IN
2495,Gwinnett County-Allegheny County-PA-1718,"Allegheny County, PA",1718,2017,2018,81,2395000,47,872000,34,1523000,Gwinnett County,Gwinnett County-Allegheny County-PA
2496,Gwinnett County-Bexar County-TX-1718,"Bexar County, TX",1718,2017,2018,95,1908000,143,2966000,-48,-1058000,Gwinnett County,Gwinnett County-Bexar County-TX
2497,Gwinnett County-San Bernardino County-CA-1718,"San Bernardino County, CA",1718,2017,2018,88,2064000,77,1265000,11,799000,Gwinnett County,Gwinnett County-San Bernardino County-CA
2498,Gwinnett County-Oconee County-GA-1718,"Oconee County, GA",1718,2017,2018,83,2980000,212,9551000,-129,-6571000,Gwinnett County,Gwinnett County-Oconee County-GA
2499,Gwinnett County-New Haven County-CT-1718,"New Haven County, CT",1718,2017,2018,84,2689000,42,1333000,42,1356000,Gwinnett County,Gwinnett County-New Haven County-CT
2500,Gwinnett County-Hennepin County-MN-1718,"Hennepin County, MN",1718,2017,2018,82,2741000,68,1151000,14,1590000,Gwinnett County,Gwinnett County-Hennepin County-MN
2501,Gwinnett County-Durham County-NC-1718,"Durham County, NC",1718,2017,2018,59,1416000,59,1982000,0,-566000,Gwinnett County,Gwinnett County-Durham County-NC
2502,Gwinnett County-Alachua County-FL-1718,"Alachua County, FL",1718,2017,2018,79,2093000,34,1542000,45,551000,Gwinnett County,Gwinnett County-Alachua County-FL
2503,Gwinnett County-Habersham County-GA-1718,"Habersham County, GA",1718,2017,2018,68,1841000,121,3690000,-53,-1849000,Gwinnett County,Gwinnett County-Habersham County-GA
2504,Gwinnett County-DuPage County-IL-1718,"DuPage County, IL",1718,2017,2018,79,1828000,57,1494000,22,334000,Gwinnett County,Gwinnett County-DuPage County-IL
2505,Gwinnett County-Anne Arundel County-MD-1718,"Anne Arundel County, MD",1718,2017,2018,78,2069000,60,1732000,18,337000,Gwinnett County,Gwinnett County-Anne Arundel County-MD
2506,Gwinnett County-Mobile County-AL-1718,"Mobile County, AL",1718,2017,2018,80,1271000,59,1554000,21,-283000,Gwinnett County,Gwinnett County-Mobile County-AL
2507,Gwinnett County-Leon County-FL-1718,"Leon County, FL",1718,2017,2018,67,1203000,60,1725000,7,-522000,Gwinnett County,Gwinnett County-Leon County-FL
2508,Gwinnett County-Escambia County-FL-1718,"Escambia County, FL",1718,2017,2018,67,1208000,65,2536000,2,-1328000,Gwinnett County,Gwinnett County-Escambia County-FL
2509,Gwinnett County-Dougherty County-GA-1718,"Dougherty County, GA",1718,2017,2018,81,895000,73,1017000,8,-122000,Gwinnett County,Gwinnett County-Dougherty County-GA
2510,Gwinnett County-El Paso County-CO-1718,"El Paso County, CO",1718,2017,2018,75,1542000,77,1558000,-2,-16000,Gwinnett County,Gwinnett County-El Paso County-CO
2511,Gwinnett County-Bay County-FL-1718,"Bay County, FL",1718,2017,2018,70,1421000,103,2987000,-33,-1566000,Gwinnett County,Gwinnett County-Bay County-FL
2512,Gwinnett County-Volusia County-FL-1718,"Volusia County, FL",1718,2017,2018,65,2538000,106,2852000,-41,-314000,Gwinnett County,Gwinnett County-Volusia County-FL
2513,Gwinnett County-Honolulu County-HI-1718,"Honolulu County, HI",1718,2017,2018,82,1711000,51,1709000,31,2000,Gwinnett County,Gwinnett County-Honolulu County-HI
2514,Gwinnett County-Bell County-TX-1718,"Bell County, TX",1718,2017,2018,69,1290000,36,618000,33,672000,Gwinnett County,Gwinnett County-Bell County-TX
2515,Gwinnett County-Shelby County-AL-1718,"Shelby County, AL",1718,2017,2018,75,2698000,56,1832000,19,866000,Gwinnett County,Gwinnett County-Shelby County-AL
2516,Gwinnett County-Denton County-TX-1718,"Denton County, TX",1718,2017,2018,72,2703000,112,3137000,-40,-434000,Gwinnett County,Gwinnett County-Denton County-TX
2517,Gwinnett County-Baltimore County-MD-1718,"Baltimore County, MD",1718,2017,2018,68,1875000,51,619000,17,1256000,Gwinnett County,Gwinnett County-Baltimore County-MD
2518,Gwinnett County-Fort Bend County-TX-1718,"Fort Bend County, TX",1718,2017,2018,70,1789000,54,1125000,16,664000,Gwinnett County,Gwinnett County-Fort Bend County-TX
2519,Gwinnett County-Hamilton County-OH-1718,"Hamilton County, OH",1718,2017,2018,61,1526000,47,806000,14,720000,Gwinnett County,Gwinnett County-Hamilton County-OH
2520,Gwinnett County-Osceola County-FL-1718,"Osceola County, FL",1718,2017,2018,56,1050000,64,1883000,-8,-833000,Gwinnett County,Gwinnett County-Osceola County-FL
2521,Gwinnett County-Pasco County-FL-1718,"Pasco County, FL",1718,2017,2018,54,1252000,92,2389000,-38,-1137000,Gwinnett County,Gwinnett County-Pasco County-FL
2522,Gwinnett County-Beaufort County-SC-1718,"Beaufort County, SC",1718,2017,2018,62,1575000,69,4374000,-7,-2799000,Gwinnett County,Gwinnett County-Beaufort County-SC
2523,Gwinnett County-Berkeley County-SC-1718,"Berkeley County, SC",1718,2017,2018,60,1088000,46,271000,14,817000,Gwinnett County,Gwinnett County-Berkeley County-SC
2524,Gwinnett County-Lexington County-SC-1718,"Lexington County, SC",1718,2017,2018,63,1224000,42,850000,21,374000,Gwinnett County,Gwinnett County-Lexington County-SC
2525,Gwinnett County-Manatee County-FL-1718,"Manatee County, FL",1718,2017,2018,57,1473000,71,4966000,-14,-3493000,Gwinnett County,Gwinnett County-Manatee County-FL
2526,Gwinnett County-Glynn County-GA-1718,"Glynn County, GA",1718,2017,2018,46,1149000,50,2243000,-4,-1094000,Gwinnett County,Gwinnett County-Glynn County-GA
2527,Gwinnett County-Forsyth County-NC-1718,"Forsyth County, NC",1718,2017,2018,49,1047000,47,1365000,2,-318000,Gwinnett County,Gwinnett County-Forsyth County-NC
2528,Gwinnett County-Horry County-SC-1718,"Horry County, SC",1718,2017,2018,45,886000,61,3202000,-16,-2316000,Gwinnett County,Gwinnett County-Horry County-SC
2529,Gwinnett County-Spartanburg County-SC-1718,"Spartanburg County, SC",1718,2017,2018,49,1226000,93,1968000,-44,-742000,Gwinnett County,Gwinnett County-Spartanburg County-SC
2530,Gwinnett County-Montgomery County-TN-1718,"Montgomery County, TN",1718,2017,2018,60,1188000,43,1001000,17,187000,Gwinnett County,Gwinnett County-Montgomery County-TN
2531,Gwinnett County-Floyd County-GA-1718,"Floyd County, GA",1718,2017,2018,56,1286000,63,2501000,-7,-1215000,Gwinnett County,Gwinnett County-Floyd County-GA
2532,Gwinnett County-Cumberland County-NC-1718,"Cumberland County, NC",1718,2017,2018,57,1361000,54,1177000,3,184000,Gwinnett County,Gwinnett County-Cumberland County-NC
2533,Gwinnett County-Norfolk city-VA-1718,"Norfolk city, VA",1718,2017,2018,53,1194000,34,501000,19,693000,Gwinnett County,Gwinnett County-Norfolk city-VA
2534,Gwinnett County-Sacramento County-CA-1718,"Sacramento County, CA",1718,2017,2018,52,1101000,58,1043000,-6,58000,Gwinnett County,Gwinnett County-Sacramento County-CA
2535,Gwinnett County-Contra Costa County-CA-1718,"Contra Costa County, CA",1718,2017,2018,41,1410000,49,1148000,-8,262000,Gwinnett County,Gwinnett County-Contra Costa County-CA
2536,Gwinnett County-District of Columbia-DC-1718,"District of Columbia, DC",1718,2017,2018,46,986000,43,1775000,3,-789000,Gwinnett County,Gwinnett County-District of Columbia-DC
2537,Gwinnett County-Lumpkin County-GA-1718,"Lumpkin County, GA",1718,2017,2018,35,1033000,60,1233000,-25,-200000,Gwinnett County,Gwinnett County-Lumpkin County-GA
2538,Gwinnett County-Arapahoe County-CO-1718,"Arapahoe County, CO",1718,2017,2018,54,1463000,54,2285000,0,-822000,Gwinnett County,Gwinnett County-Arapahoe County-CO
2539,Gwinnett County-Clay County-FL-1718,"Clay County, FL",1718,2017,2018,59,1196000,51,1296000,8,-100000,Gwinnett County,Gwinnett County-Clay County-FL
2540,Gwinnett County-Erie County-NY-1718,"Erie County, NY",1718,2017,2018,56,654000,60,1340000,-4,-686000,Gwinnett County,Gwinnett County-Erie County-NY
2541,Gwinnett County-Rutherford County-TN-1718,"Rutherford County, TN",1718,2017,2018,50,1245000,81,2498000,-31,-1253000,Gwinnett County,Gwinnett County-Rutherford County-TN
2542,Gwinnett County-St. Lucie County-FL-1718,"St. Lucie County, FL",1718,2017,2018,48,971000,43,1604000,5,-633000,Gwinnett County,Gwinnett County-St. Lucie County-FL
2543,Gwinnett County-Spalding County-GA-1718,"Spalding County, GA",1718,2017,2018,42,1146000,118,2446000,-76,-1300000,Gwinnett County,Gwinnett County-Spalding County-GA
2544,Gwinnett County-Baltimore city-MD-1718,"Baltimore city, MD",1718,2017,2018,54,742000,44,518000,10,224000,Gwinnett County,Gwinnett County-Baltimore city-MD
2545,Gwinnett County-Onslow County-NC-1718,"Onslow County, NC",1718,2017,2018,51,1120000,53,771000,-2,349000,Gwinnett County,Gwinnett County-Onslow County-NC
2546,Gwinnett County-Delaware County-PA-1718,"Delaware County, PA",1718,2017,2018,51,1069000,50,585000,1,484000,Gwinnett County,Gwinnett County-Delaware County-PA
2547,Gwinnett County-Lake County-FL-1718,"Lake County, FL",1718,2017,2018,51,1007000,62,1507000,-11,-500000,Gwinnett County,Gwinnett County-Lake County-FL
2548,Gwinnett County-White County-GA-1718,"White County, GA",1718,2017,2018,32,651000,67,1900000,-35,-1249000,Gwinnett County,Gwinnett County-White County-GA
2549,Gwinnett County-Pierce County-WA-1718,"Pierce County, WA",1718,2017,2018,49,717000,63,1346000,-14,-629000,Gwinnett County,Gwinnett County-Pierce County-WA
2550,Gwinnett County-Pima County-AZ-1718,"Pima County, AZ",1718,2017,2018,36,1072000,40,1173000,-4,-101000,Gwinnett County,Gwinnett County-Pima County-AZ
2551,Gwinnett County-St. Johns County-FL-1718,"St. Johns County, FL",1718,2017,2018,37,1260000,150,10305000,-113,-9045000,Gwinnett County,Gwinnett County-St. Johns County-FL
2552,Gwinnett County-York County-SC-1718,"York County, SC",1718,2017,2018,55,1667000,43,1768000,12,-101000,Gwinnett County,Gwinnett County-York County-SC
2553,Gwinnett County-Harrison County-MS-1718,"Harrison County, MS",1718,2017,2018,48,1006000,45,957000,3,49000,Gwinnett County,Gwinnett County-Harrison County-MS
2554,Gwinnett County-Henrico County-VA-1718,"Henrico County, VA",1718,2017,2018,46,828000,45,909000,1,-81000,Gwinnett County,Gwinnett County-Henrico County-VA
2556,Henry County-Clayton County-GA-1718,"Clayton County, GA",1718,2017,2018,5003,87146000,2883,44961000,2120,42185000,Henry County,Henry County-Clayton County-GA
2557,Henry County-DeKalb County-GA-1718,"DeKalb County, GA",1718,2017,2018,1798,33169000,982,23640000,816,9529000,Henry County,Henry County-DeKalb County-GA
2558,Henry County-Fulton County-GA-1718,"Fulton County, GA",1718,2017,2018,1501,29905000,1336,41940000,165,-12035000,Henry County,Henry County-Fulton County-GA
2559,Henry County-Gwinnett County-GA-1718,"Gwinnett County, GA",1718,2017,2018,582,14065000,581,15762000,1,-1697000,Henry County,Henry County-Gwinnett County-GA
2560,Henry County-Spalding County-GA-1718,"Spalding County, GA",1718,2017,2018,600,10344000,928,19647000,-328,-9303000,Henry County,Henry County-Spalding County-GA
2561,Henry County-Cobb County-GA-1718,"Cobb County, GA",1718,2017,2018,461,12600000,515,15493000,-54,-2893000,Henry County,Henry County-Cobb County-GA
2562,Henry County-Rockdale County-GA-1718,"Rockdale County, GA",1718,2017,2018,398,8221000,315,7666000,83,555000,Henry County,Henry County-Rockdale County-GA
2563,Henry County-Newton County-GA-1718,"Newton County, GA",1718,2017,2018,381,6943000,415,7973000,-34,-1030000,Henry County,Henry County-Newton County-GA
2564,Henry County-Fayette County-GA-1718,"Fayette County, GA",1718,2017,2018,338,8952000,424,13613000,-86,-4661000,Henry County,Henry County-Fayette County-GA
2565,Henry County-Butts County-GA-1718,"Butts County, GA",1718,2017,2018,352,5737000,642,15961000,-290,-10224000,Henry County,Henry County-Butts County-GA
2566,Henry County-Bibb County-GA-1718,"Bibb County, GA",1718,2017,2018,220,4390000,117,2393000,103,1997000,Henry County,Henry County-Bibb County-GA
2567,Henry County-Coweta County-GA-1718,"Coweta County, GA",1718,2017,2018,207,4660000,349,12153000,-142,-7493000,Henry County,Henry County-Coweta County-GA
2568,Henry County-Broward County-FL-1718,"Broward County, FL",1718,2017,2018,172,3057000,73,1539000,99,1518000,Henry County,Henry County-Broward County-FL
2569,Henry County-Houston County-GA-1718,"Houston County, GA",1718,2017,2018,165,2962000,114,2630000,51,332000,Henry County,Henry County-Houston County-GA
2570,Henry County-Douglas County-GA-1718,"Douglas County, GA",1718,2017,2018,164,3560000,149,3014000,15,546000,Henry County,Henry County-Douglas County-GA
2571,Henry County-Miami-Dade County-FL-1718,"Miami-Dade County, FL",1718,2017,2018,137,2359000,48,1705000,89,654000,Henry County,Henry County-Miami-Dade County-FL
2572,Henry County-Chatham County-GA-1718,"Chatham County, GA",1718,2017,2018,113,2971000,75,2055000,38,916000,Henry County,Henry County-Chatham County-GA
2573,Henry County-Orange County-FL-1718,"Orange County, FL",1718,2017,2018,105,2005000,72,1317000,33,688000,Henry County,Henry County-Orange County-FL
2574,Henry County-Cook County-IL-1718,"Cook County, IL",1718,2017,2018,109,2161000,42,884000,67,1277000,Henry County,Henry County-Cook County-IL
2575,Henry County-Los Angeles County-CA-1718,"Los Angeles County, CA",1718,2017,2018,87,2607000,44,950000,43,1657000,Henry County,Henry County-Los Angeles County-CA
2576,Henry County-Muscogee County-GA-1718,"Muscogee County, GA",1718,2017,2018,103,1754000,38,832000,65,922000,Henry County,Henry County-Muscogee County-GA
2577,Henry County-Lamar County-GA-1718,"Lamar County, GA",1718,2017,2018,79,1526000,189,5067000,-110,-3541000,Henry County,Henry County-Lamar County-GA
2578,Henry County-Monroe County-GA-1718,"Monroe County, GA",1718,2017,2018,85,1917000,161,3775000,-76,-1858000,Henry County,Henry County-Monroe County-GA
2579,Henry County-Hillsborough County-FL-1718,"Hillsborough County, FL",1718,2017,2018,77,1234000,61,1243000,16,-9000,Henry County,Henry County-Hillsborough County-FL
2580,Henry County-Paulding County-GA-1718,"Paulding County, GA",1718,2017,2018,76,1314000,97,2368000,-21,-1054000,Henry County,Henry County-Paulding County-GA
2581,Henry County-Walton County-GA-1718,"Walton County, GA",1718,2017,2018,63,1558000,86,2558000,-23,-1000000,Henry County,Henry County-Walton County-GA
2582,Henry County-Harris County-TX-1718,"Harris County, TX",1718,2017,2018,54,1385000,46,1138000,8,247000,Henry County,Henry County-Harris County-TX
2583,Henry County-Duval County-FL-1718,"Duval County, FL",1718,2017,2018,58,1622000,76,1409000,-18,213000,Henry County,Henry County-Duval County-FL
2584,Henry County-Upson County-GA-1718,"Upson County, GA",1718,2017,2018,50,865000,61,1133000,-11,-268000,Henry County,Henry County-Upson County-GA
2585,Henry County-Jasper County-GA-1718,"Jasper County, GA",1718,2017,2018,56,900000,136,5293000,-80,-4393000,Henry County,Henry County-Jasper County-GA
2586,Henry County-Carroll County-GA-1718,"Carroll County, GA",1718,2017,2018,48,679000,42,680000,6,-1000,Henry County,Henry County-Carroll County-GA
2587,Henry County-Pike County-GA-1718,"Pike County, GA",1718,2017,2018,44,1234000,182,5758000,-138,-4524000,Henry County,Henry County-Pike County-GA
2588,Henry County-Cherokee County-GA-1718,"Cherokee County, GA",1718,2017,2018,54,1178000,130,4625000,-76,-3447000,Henry County,Henry County-Cherokee County-GA
2589,Henry County-Clarke County-GA-1718,"Clarke County, GA",1718,2017,2018,41,938000,36,670000,5,268000,Henry County,Henry County-Clarke County-GA
2591,Rockdale County-DeKalb County-GA-1718,"DeKalb County, GA",1718,2017,2018,1934,33496000,1222,21355000,712,12141000,Rockdale County,Rockdale County-DeKalb County-GA
2592,Rockdale County-Newton County-GA-1718,"Newton County, GA",1718,2017,2018,1400,20354000,1761,27346000,-361,-6992000,Rockdale County,Rockdale County-Newton County-GA
2593,Rockdale County-Gwinnett County-GA-1718,"Gwinnett County, GA",1718,2017,2018,701,13500000,578,12589000,123,911000,Rockdale County,Rockdale County-Gwinnett County-GA
2594,Rockdale County-Fulton County-GA-1718,"Fulton County, GA",1718,2017,2018,351,6624000,461,10804000,-110,-4180000,Rockdale County,Rockdale County-Fulton County-GA
2595,Rockdale County-Henry County-GA-1718,"Henry County, GA",1718,2017,2018,315,7666000,398,8221000,-83,-555000,Rockdale County,Rockdale County-Henry County-GA
2596,Rockdale County-Clayton County-GA-1718,"Clayton County, GA",1718,2017,2018,266,4249000,223,2926000,43,1323000,Rockdale County,Rockdale County-Clayton County-GA
2597,Rockdale County-Walton County-GA-1718,"Walton County, GA",1718,2017,2018,184,3296000,343,8885000,-159,-5589000,Rockdale County,Rockdale County-Walton County-GA
2598,Rockdale County-Cobb County-GA-1718,"Cobb County, GA",1718,2017,2018,128,2922000,178,4433000,-50,-1511000,Rockdale County,Rockdale County-Cobb County-GA
2599,Rockdale County-Douglas County-GA-1718,"Douglas County, GA",1718,2017,2018,41,744000,62,918000,-21,-174000,Rockdale County,Rockdale County-Douglas County-GA
2601,Cherokee County-Cobb County-GA-1819,"Cobb County, GA",1819,2018,2019,4699,175529000,2985,99758000,1714,75771000,Cherokee County,Cherokee County-Cobb County-GA
2602,Cherokee County-Fulton County-GA-1819,"Fulton County, GA",1819,2018,2019,2441,127181000,1163,57443000,1278,69738000,Cherokee County,Cherokee County-Fulton County-GA
2603,Cherokee County-Forsyth County-GA-1819,"Forsyth County, GA",1819,2018,2019,837,37399000,614,23179000,223,14220000,Cherokee County,Cherokee County-Forsyth County-GA
2604,Cherokee County-Gwinnett County-GA-1819,"Gwinnett County, GA",1819,2018,2019,653,25413000,426,12849000,227,12564000,Cherokee County,Cherokee County-Gwinnett County-GA
2605,Cherokee County-DeKalb County-GA-1819,"DeKalb County, GA",1819,2018,2019,431,17957000,288,11419000,143,6538000,Cherokee County,Cherokee County-DeKalb County-GA
2606,Cherokee County-Paulding County-GA-1819,"Paulding County, GA",1819,2018,2019,459,14450000,495,12439000,-36,2011000,Cherokee County,Cherokee County-Paulding County-GA
2607,Cherokee County-Bartow County-GA-1819,"Bartow County, GA",1819,2018,2019,467,12114000,950,20559000,-483,-8445000,Cherokee County,Cherokee County-Bartow County-GA
2608,Cherokee County-Pickens County-GA-1819,"Pickens County, GA",1819,2018,2019,473,14636000,642,16292000,-169,-1656000,Cherokee County,Cherokee County-Pickens County-GA
2609,Cherokee County-Hall County-GA-1819,"Hall County, GA",1819,2018,2019,101,4155000,135,4126000,-34,29000,Cherokee County,Cherokee County-Hall County-GA
2610,Cherokee County-Henry County-GA-1819,"Henry County, GA",1819,2018,2019,130,4691000,58,1158000,72,3533000,Cherokee County,Cherokee County-Henry County-GA
2611,Cherokee County-Gilmer County-GA-1819,"Gilmer County, GA",1819,2018,2019,105,3010000,169,6548000,-64,-3538000,Cherokee County,Cherokee County-Gilmer County-GA
2612,Cherokee County-Palm Beach County-FL-1819,"Palm Beach County, FL",1819,2018,2019,83,2916000,57,2396000,26,520000,Cherokee County,Cherokee County-Palm Beach County-FL
2613,Cherokee County-Douglas County-GA-1819,"Douglas County, GA",1819,2018,2019,80,2083000,59,834000,21,1249000,Cherokee County,Cherokee County-Douglas County-GA
2614,Cherokee County-Fayette County-GA-1819,"Fayette County, GA",1819,2018,2019,80,3652000,38,1160000,42,2492000,Cherokee County,Cherokee County-Fayette County-GA
2615,Cherokee County-Coweta County-GA-1819,"Coweta County, GA",1819,2018,2019,61,1877000,76,2402000,-15,-525000,Cherokee County,Cherokee County-Coweta County-GA
2616,Cherokee County-Orange County-FL-1819,"Orange County, FL",1819,2018,2019,69,2306000,74,2320000,-5,-14000,Cherokee County,Cherokee County-Orange County-FL
2617,Cherokee County-Floyd County-GA-1819,"Floyd County, GA",1819,2018,2019,64,1612000,79,979000,-15,633000,Cherokee County,Cherokee County-Floyd County-GA
2618,Cherokee County-Maricopa County-AZ-1819,"Maricopa County, AZ",1819,2018,2019,67,2221000,58,4782000,9,-2561000,Cherokee County,Cherokee County-Maricopa County-AZ
2619,Cherokee County-Chatham County-GA-1819,"Chatham County, GA",1819,2018,2019,51,1599000,41,1572000,10,27000,Cherokee County,Cherokee County-Chatham County-GA
2620,Cherokee County-Pinellas County-FL-1819,"Pinellas County, FL",1819,2018,2019,43,1647000,63,3717000,-20,-2070000,Cherokee County,Cherokee County-Pinellas County-FL
2621,Cherokee County-Duval County-FL-1819,"Duval County, FL",1819,2018,2019,50,1630000,53,1941000,-3,-311000,Cherokee County,Cherokee County-Duval County-FL
2622,Cherokee County-Carroll County-GA-1819,"Carroll County, GA",1819,2018,2019,59,1448000,62,1315000,-3,133000,Cherokee County,Cherokee County-Carroll County-GA
2623,Cherokee County-Gordon County-GA-1819,"Gordon County, GA",1819,2018,2019,55,1316000,103,2495000,-48,-1179000,Cherokee County,Cherokee County-Gordon County-GA
2624,Cherokee County-Hamilton County-TN-1819,"Hamilton County, TN",1819,2018,2019,47,1474000,56,2807000,-9,-1333000,Cherokee County,Cherokee County-Hamilton County-TN
2625,Cherokee County-Hillsborough County-FL-1819,"Hillsborough County, FL",1819,2018,2019,51,3209000,54,2279000,-3,930000,Cherokee County,Cherokee County-Hillsborough County-FL
2626,Cherokee County-Lee County-FL-1819,"Lee County, FL",1819,2018,2019,45,1948000,36,2073000,9,-125000,Cherokee County,Cherokee County-Lee County-FL
2627,Cherokee County-Lumpkin County-GA-1819,"Lumpkin County, GA",1819,2018,2019,36,905000,41,1613000,-5,-708000,Cherokee County,Cherokee County-Lumpkin County-GA
2628,Cherokee County-Mecklenburg County-NC-1819,"Mecklenburg County, NC",1819,2018,2019,45,1999000,53,2814000,-8,-815000,Cherokee County,Cherokee County-Mecklenburg County-NC
2629,Cherokee County-Brevard County-FL-1819,"Brevard County, FL",1819,2018,2019,35,1351000,41,1811000,-6,-460000,Cherokee County,Cherokee County-Brevard County-FL
2630,Cherokee County-Volusia County-FL-1819,"Volusia County, FL",1819,2018,2019,32,803000,40,1684000,-8,-881000,Cherokee County,Cherokee County-Volusia County-FL
2632,Clayton County-Fulton County-GA-1819,"Fulton County, GA",1819,2018,2019,7321,88978000,6334,84486000,987,4492000,Clayton County,Clayton County-Fulton County-GA
2633,Clayton County-DeKalb County-GA-1819,"DeKalb County, GA",1819,2018,2019,3315,44032000,2659,35185000,656,8847000,Clayton County,Clayton County-DeKalb County-GA
2634,Clayton County-Henry County-GA-1819,"Henry County, GA",1819,2018,2019,2819,43647000,4902,82958000,-2083,-39311000,Clayton County,Clayton County-Henry County-GA
2635,Clayton County-Cobb County-GA-1819,"Cobb County, GA",1819,2018,2019,955,15877000,1020,17232000,-65,-1355000,Clayton County,Clayton County-Cobb County-GA
2636,Clayton County-Gwinnett County-GA-1819,"Gwinnett County, GA",1819,2018,2019,821,11465000,913,14088000,-92,-2623000,Clayton County,Clayton County-Gwinnett County-GA
2637,Clayton County-Fayette County-GA-1819,"Fayette County, GA",1819,2018,2019,444,7851000,980,19601000,-536,-11750000,Clayton County,Clayton County-Fayette County-GA
2638,Clayton County-Douglas County-GA-1819,"Douglas County, GA",1819,2018,2019,384,5131000,384,5640000,0,-509000,Clayton County,Clayton County-Douglas County-GA
2639,Clayton County-Spalding County-GA-1819,"Spalding County, GA",1819,2018,2019,370,3825000,482,6671000,-112,-2846000,Clayton County,Clayton County-Spalding County-GA
2640,Clayton County-Miami-Dade County-FL-1819,"Miami-Dade County, FL",1819,2018,2019,259,3273000,138,1914000,121,1359000,Clayton County,Clayton County-Miami-Dade County-FL
2641,Clayton County-Rockdale County-GA-1819,"Rockdale County, GA",1819,2018,2019,270,3815000,249,3978000,21,-163000,Clayton County,Clayton County-Rockdale County-GA
2642,Clayton County-Broward County-FL-1819,"Broward County, FL",1819,2018,2019,247,2608000,81,1685000,166,923000,Clayton County,Clayton County-Broward County-FL
2643,Clayton County-Newton County-GA-1819,"Newton County, GA",1819,2018,2019,219,3065000,254,3642000,-35,-577000,Clayton County,Clayton County-Newton County-GA
2644,Clayton County-Coweta County-GA-1819,"Coweta County, GA",1819,2018,2019,208,2698000,362,7718000,-154,-5020000,Clayton County,Clayton County-Coweta County-GA
2645,Clayton County-Kings County-NY-1819,"Kings County, NY",1819,2018,2019,148,2607000,52,1038000,96,1569000,Clayton County,Clayton County-Kings County-NY
2646,Clayton County-Chatham County-GA-1819,"Chatham County, GA",1819,2018,2019,137,1946000,110,1342000,27,604000,Clayton County,Clayton County-Chatham County-GA
2647,Clayton County-Cook County-IL-1819,"Cook County, IL",1819,2018,2019,127,1818000,80,972000,47,846000,Clayton County,Clayton County-Cook County-IL
2648,Clayton County-Bibb County-GA-1819,"Bibb County, GA",1819,2018,2019,136,1518000,102,1418000,34,100000,Clayton County,Clayton County-Bibb County-GA
2649,Clayton County-Orange County-FL-1819,"Orange County, FL",1819,2018,2019,121,1557000,96,1141000,25,416000,Clayton County,Clayton County-Orange County-FL
2650,Clayton County-Muscogee County-GA-1819,"Muscogee County, GA",1819,2018,2019,120,1549000,106,1228000,14,321000,Clayton County,Clayton County-Muscogee County-GA
2651,Clayton County-Los Angeles County-CA-1819,"Los Angeles County, CA",1819,2018,2019,103,1544000,53,895000,50,649000,Clayton County,Clayton County-Los Angeles County-CA
2652,Clayton County-Duval County-FL-1819,"Duval County, FL",1819,2018,2019,108,1581000,80,877000,28,704000,Clayton County,Clayton County-Duval County-FL
2653,Clayton County-Hillsborough County-FL-1819,"Hillsborough County, FL",1819,2018,2019,116,1128000,71,1132000,45,-4000,Clayton County,Clayton County-Hillsborough County-FL
2654,Clayton County-Palm Beach County-FL-1819,"Palm Beach County, FL",1819,2018,2019,80,751000,56,790000,24,-39000,Clayton County,Clayton County-Palm Beach County-FL
2655,Clayton County-Harris County-TX-1819,"Harris County, TX",1819,2018,2019,77,1022000,83,1202000,-6,-180000,Clayton County,Clayton County-Harris County-TX
2656,Clayton County-Prince George's County-MD-1819,"Prince George's County, MD",1819,2018,2019,73,1699000,33,669000,40,1030000,Clayton County,Clayton County-Prince George's County-MD
2657,Clayton County-Carroll County-GA-1819,"Carroll County, GA",1819,2018,2019,75,884000,90,1141000,-15,-257000,Clayton County,Clayton County-Carroll County-GA
2658,Clayton County-Dallas County-TX-1819,"Dallas County, TX",1819,2018,2019,78,1135000,70,770000,8,365000,Clayton County,Clayton County-Dallas County-TX
2659,Clayton County-Dougherty County-GA-1819,"Dougherty County, GA",1819,2018,2019,71,772000,63,613000,8,159000,Clayton County,Clayton County-Dougherty County-GA
2660,Clayton County-Paulding County-GA-1819,"Paulding County, GA",1819,2018,2019,63,947000,122,2216000,-59,-1269000,Clayton County,Clayton County-Paulding County-GA
2661,Clayton County-Houston County-GA-1819,"Houston County, GA",1819,2018,2019,80,939000,57,804000,23,135000,Clayton County,Clayton County-Houston County-GA
2662,Clayton County-Troup County-GA-1819,"Troup County, GA",1819,2018,2019,65,928000,46,601000,19,327000,Clayton County,Clayton County-Troup County-GA
2663,Clayton County-Shelby County-TN-1819,"Shelby County, TN",1819,2018,2019,72,823000,65,776000,7,47000,Clayton County,Clayton County-Shelby County-TN
2664,Clayton County-Richmond County-GA-1819,"Richmond County, GA",1819,2018,2019,59,708000,70,970000,-11,-262000,Clayton County,Clayton County-Richmond County-GA
2665,Clayton County-Mecklenburg County-NC-1819,"Mecklenburg County, NC",1819,2018,2019,57,1126000,84,1125000,-27,1000,Clayton County,Clayton County-Mecklenburg County-NC
2666,Clayton County-Wayne County-MI-1819,"Wayne County, MI",1819,2018,2019,54,661000,51,656000,3,5000,Clayton County,Clayton County-Wayne County-MI
2667,Clayton County-Jefferson County-AL-1819,"Jefferson County, AL",1819,2018,2019,52,725000,69,1082000,-17,-357000,Clayton County,Clayton County-Jefferson County-AL
2668,Clayton County-Maricopa County-AZ-1819,"Maricopa County, AZ",1819,2018,2019,55,911000,48,557000,7,354000,Clayton County,Clayton County-Maricopa County-AZ
2669,Clayton County-Montgomery County-AL-1819,"Montgomery County, AL",1819,2018,2019,57,586000,63,570000,-6,16000,Clayton County,Clayton County-Montgomery County-AL
2670,Clayton County-Butts County-GA-1819,"Butts County, GA",1819,2018,2019,54,781000,77,1453000,-23,-672000,Clayton County,Clayton County-Butts County-GA
2671,Clayton County-San Diego County-CA-1819,"San Diego County, CA",1819,2018,2019,35,788000,43,1019000,-8,-231000,Clayton County,Clayton County-San Diego County-CA
2672,Clayton County-Clark County-NV-1819,"Clark County, NV",1819,2018,2019,50,488000,56,1005000,-6,-517000,Clayton County,Clayton County-Clark County-NV
2673,Clayton County-Hall County-GA-1819,"Hall County, GA",1819,2018,2019,40,538000,54,837000,-14,-299000,Clayton County,Clayton County-Hall County-GA
2674,Clayton County-Cumberland County-NC-1819,"Cumberland County, NC",1819,2018,2019,34,1203000,60,811000,-26,392000,Clayton County,Clayton County-Cumberland County-NC
2675,Clayton County-Walton County-GA-1819,"Walton County, GA",1819,2018,2019,34,808000,61,1105000,-27,-297000,Clayton County,Clayton County-Walton County-GA
2676,Clayton County-Richland County-SC-1819,"Richland County, SC",1819,2018,2019,42,777000,39,396000,3,381000,Clayton County,Clayton County-Richland County-SC
2678,Cobb County-Fulton County-GA-1819,"Fulton County, GA",1819,2018,2019,8999,420128000,8387,440190000,612,-20062000,Cobb County,Cobb County-Fulton County-GA
2679,Cobb County-DeKalb County-GA-1819,"DeKalb County, GA",1819,2018,2019,3341,127705000,2897,105810000,444,21895000,Cobb County,Cobb County-DeKalb County-GA
2680,Cobb County-Cherokee County-GA-1819,"Cherokee County, GA",1819,2018,2019,2985,99758000,4699,175529000,-1714,-75771000,Cobb County,Cobb County-Cherokee County-GA
2681,Cobb County-Paulding County-GA-1819,"Paulding County, GA",1819,2018,2019,2781,82829000,5057,130684000,-2276,-47855000,Cobb County,Cobb County-Paulding County-GA
2682,Cobb County-Gwinnett County-GA-1819,"Gwinnett County, GA",1819,2018,2019,2088,59918000,2249,59776000,-161,142000,Cobb County,Cobb County-Gwinnett County-GA
2683,Cobb County-Douglas County-GA-1819,"Douglas County, GA",1819,2018,2019,1995,39439000,2779,48527000,-784,-9088000,Cobb County,Cobb County-Douglas County-GA
2684,Cobb County-Clayton County-GA-1819,"Clayton County, GA",1819,2018,2019,1020,17232000,955,15877000,65,1355000,Cobb County,Cobb County-Clayton County-GA
2685,Cobb County-Bartow County-GA-1819,"Bartow County, GA",1819,2018,2019,663,18041000,1348,41361000,-685,-23320000,Cobb County,Cobb County-Bartow County-GA
2686,Cobb County-Henry County-GA-1819,"Henry County, GA",1819,2018,2019,540,21602000,559,14102000,-19,7500000,Cobb County,Cobb County-Henry County-GA
2687,Cobb County-Los Angeles County-CA-1819,"Los Angeles County, CA",1819,2018,2019,434,17250000,275,10988000,159,6262000,Cobb County,Cobb County-Los Angeles County-CA
2688,Cobb County-Forsyth County-GA-1819,"Forsyth County, GA",1819,2018,2019,388,17081000,864,36194000,-476,-19113000,Cobb County,Cobb County-Forsyth County-GA
2689,Cobb County-Broward County-FL-1819,"Broward County, FL",1819,2018,2019,435,11783000,305,11957000,130,-174000,Cobb County,Cobb County-Broward County-FL
2690,Cobb County-Cook County-IL-1819,"Cook County, IL",1819,2018,2019,369,14172000,204,8932000,165,5240000,Cobb County,Cobb County-Cook County-IL
2691,Cobb County-Miami-Dade County-FL-1819,"Miami-Dade County, FL",1819,2018,2019,388,9911000,245,6418000,143,3493000,Cobb County,Cobb County-Miami-Dade County-FL
2692,Cobb County-Fayette County-GA-1819,"Fayette County, GA",1819,2018,2019,239,9504000,261,11367000,-22,-1863000,Cobb County,Cobb County-Fayette County-GA
2693,Cobb County-Orange County-FL-1819,"Orange County, FL",1819,2018,2019,279,6864000,272,10432000,7,-3568000,Cobb County,Cobb County-Orange County-FL
2694,Cobb County-Coweta County-GA-1819,"Coweta County, GA",1819,2018,2019,208,8872000,284,14201000,-76,-5329000,Cobb County,Cobb County-Coweta County-GA
2695,Cobb County-Mecklenburg County-NC-1819,"Mecklenburg County, NC",1819,2018,2019,260,9916000,248,11046000,12,-1130000,Cobb County,Cobb County-Mecklenburg County-NC
2696,Cobb County-Palm Beach County-FL-1819,"Palm Beach County, FL",1819,2018,2019,244,8408000,172,6734000,72,1674000,Cobb County,Cobb County-Palm Beach County-FL
2697,Cobb County-Harris County-TX-1819,"Harris County, TX",1819,2018,2019,282,11370000,229,6697000,53,4673000,Cobb County,Cobb County-Harris County-TX
2698,Cobb County-Chatham County-GA-1819,"Chatham County, GA",1819,2018,2019,225,7450000,163,5027000,62,2423000,Cobb County,Cobb County-Chatham County-GA
2699,Cobb County-Carroll County-GA-1819,"Carroll County, GA",1819,2018,2019,256,5261000,333,7807000,-77,-2546000,Cobb County,Cobb County-Carroll County-GA
2700,Cobb County-Hillsborough County-FL-1819,"Hillsborough County, FL",1819,2018,2019,240,8993000,241,10056000,-1,-1063000,Cobb County,Cobb County-Hillsborough County-FL
2701,Cobb County-Kings County-NY-1819,"Kings County, NY",1819,2018,2019,217,7633000,99,2723000,118,4910000,Cobb County,Cobb County-Kings County-NY
2702,Cobb County-Duval County-FL-1819,"Duval County, FL",1819,2018,2019,196,4947000,197,7869000,-1,-2922000,Cobb County,Cobb County-Duval County-FL
2703,Cobb County-Jefferson County-AL-1819,"Jefferson County, AL",1819,2018,2019,183,6884000,180,10362000,3,-3478000,Cobb County,Cobb County-Jefferson County-AL
2704,Cobb County-Davidson County-TN-1819,"Davidson County, TN",1819,2018,2019,165,7727000,145,7881000,20,-154000,Cobb County,Cobb County-Davidson County-TN
2705,Cobb County-Dallas County-TX-1819,"Dallas County, TX",1819,2018,2019,202,7007000,194,11389000,8,-4382000,Cobb County,Cobb County-Dallas County-TX
2706,Cobb County-Clarke County-GA-1819,"Clarke County, GA",1819,2018,2019,133,4541000,109,3722000,24,819000,Cobb County,Cobb County-Clarke County-GA
2707,Cobb County-Maricopa County-AZ-1819,"Maricopa County, AZ",1819,2018,2019,187,7418000,253,13632000,-66,-6214000,Cobb County,Cobb County-Maricopa County-AZ
2708,Cobb County-Hall County-GA-1819,"Hall County, GA",1819,2018,2019,165,4897000,162,9186000,3,-4289000,Cobb County,Cobb County-Hall County-GA
2709,Cobb County-Rockdale County-GA-1819,"Rockdale County, GA",1819,2018,2019,163,4883000,158,2929000,5,1954000,Cobb County,Cobb County-Rockdale County-GA
2710,Cobb County-Bibb County-GA-1819,"Bibb County, GA",1819,2018,2019,147,5910000,77,1522000,70,4388000,Cobb County,Cobb County-Bibb County-GA
2711,Cobb County-Muscogee County-GA-1819,"Muscogee County, GA",1819,2018,2019,156,5408000,132,2787000,24,2621000,Cobb County,Cobb County-Muscogee County-GA
2712,Cobb County-Shelby County-TN-1819,"Shelby County, TN",1819,2018,2019,165,9992000,131,3403000,34,6589000,Cobb County,Cobb County-Shelby County-TN
2713,Cobb County-Queens County-NY-1819,"Queens County, NY",1819,2018,2019,145,5229000,65,1518000,80,3711000,Cobb County,Cobb County-Queens County-NY
2714,Cobb County-San Diego County-CA-1819,"San Diego County, CA",1819,2018,2019,158,3864000,141,6144000,17,-2280000,Cobb County,Cobb County-San Diego County-CA
2715,Cobb County-Wake County-NC-1819,"Wake County, NC",1819,2018,2019,158,6130000,166,8289000,-8,-2159000,Cobb County,Cobb County-Wake County-NC
2716,Cobb County-Hamilton County-TN-1819,"Hamilton County, TN",1819,2018,2019,155,5601000,178,7703000,-23,-2102000,Cobb County,Cobb County-Hamilton County-TN
2717,Cobb County-Richmond County-GA-1819,"Richmond County, GA",1819,2018,2019,128,3137000,93,1906000,35,1231000,Cobb County,Cobb County-Richmond County-GA
2718,Cobb County-Floyd County-GA-1819,"Floyd County, GA",1819,2018,2019,141,4434000,199,6021000,-58,-1587000,Cobb County,Cobb County-Floyd County-GA
2719,Cobb County-Houston County-GA-1819,"Houston County, GA",1819,2018,2019,134,4083000,97,2651000,37,1432000,Cobb County,Cobb County-Houston County-GA
2720,Cobb County-Oakland County-MI-1819,"Oakland County, MI",1819,2018,2019,162,8007000,82,2631000,80,5376000,Cobb County,Cobb County-Oakland County-MI
2721,Cobb County-Newton County-GA-1819,"Newton County, GA",1819,2018,2019,139,3479000,140,3759000,-1,-280000,Cobb County,Cobb County-Newton County-GA
2722,Cobb County-Pinellas County-FL-1819,"Pinellas County, FL",1819,2018,2019,121,4408000,159,7166000,-38,-2758000,Cobb County,Cobb County-Pinellas County-FL
2723,Cobb County-Franklin County-OH-1819,"Franklin County, OH",1819,2018,2019,124,4631000,81,3673000,43,958000,Cobb County,Cobb County-Franklin County-OH
2724,Cobb County-Charleston County-SC-1819,"Charleston County, SC",1819,2018,2019,107,4391000,138,13155000,-31,-8764000,Cobb County,Cobb County-Charleston County-SC
2725,Cobb County-Tarrant County-TX-1819,"Tarrant County, TX",1819,2018,2019,140,5661000,143,5562000,-3,99000,Cobb County,Cobb County-Tarrant County-TX
2726,Cobb County-Orange County-CA-1819,"Orange County, CA",1819,2018,2019,136,5720000,71,2841000,65,2879000,Cobb County,Cobb County-Orange County-CA
2727,Cobb County-Clark County-NV-1819,"Clark County, NV",1819,2018,2019,115,4597000,149,5212000,-34,-615000,Cobb County,Cobb County-Clark County-NV
2728,Cobb County-Prince George's County-MD-1819,"Prince George's County, MD",1819,2018,2019,100,2957000,79,2789000,21,168000,Cobb County,Cobb County-Prince George's County-MD
2729,Cobb County-New York County-NY-1819,"New York County, NY",1819,2018,2019,77,5214000,116,6745000,-39,-1531000,Cobb County,Cobb County-New York County-NY
2730,Cobb County-Bronx County-NY-1819,"Bronx County, NY",1819,2018,2019,102,1954000,29,470000,73,1484000,Cobb County,Cobb County-Bronx County-NY
2731,Cobb County-Santa Clara County-CA-1819,"Santa Clara County, CA",1819,2018,2019,100,9072000,75,4893000,25,4179000,Cobb County,Cobb County-Santa Clara County-CA
2732,Cobb County-Collin County-TX-1819,"Collin County, TX",1819,2018,2019,109,5099000,103,3621000,6,1478000,Cobb County,Cobb County-Collin County-TX
2733,Cobb County-Lee County-AL-1819,"Lee County, AL",1819,2018,2019,76,2303000,34,2208000,42,95000,Cobb County,Cobb County-Lee County-AL
2734,Cobb County-Wayne County-MI-1819,"Wayne County, MI",1819,2018,2019,90,3213000,87,1823000,3,1390000,Cobb County,Cobb County-Wayne County-MI
2735,Cobb County-Fairfax County-VA-1819,"Fairfax County, VA",1819,2018,2019,114,7486000,105,5580000,9,1906000,Cobb County,Cobb County-Fairfax County-VA
2736,Cobb County-King County-WA-1819,"King County, WA",1819,2018,2019,109,5624000,157,10008000,-48,-4384000,Cobb County,Cobb County-King County-WA
2737,Cobb County-Greenville County-SC-1819,"Greenville County, SC",1819,2018,2019,93,2551000,125,4571000,-32,-2020000,Cobb County,Cobb County-Greenville County-SC
2738,Cobb County-Bexar County-TX-1819,"Bexar County, TX",1819,2018,2019,118,3529000,88,2653000,30,876000,Cobb County,Cobb County-Bexar County-TX
2739,Cobb County-Dougherty County-GA-1819,"Dougherty County, GA",1819,2018,2019,68,1712000,48,737000,20,975000,Cobb County,Cobb County-Dougherty County-GA
2740,Cobb County-Seminole County-FL-1819,"Seminole County, FL",1819,2018,2019,93,4211000,61,2192000,32,2019000,Cobb County,Cobb County-Seminole County-FL
2741,Cobb County-St. Louis County-MO-1819,"St. Louis County, MO",1819,2018,2019,96,2261000,61,2714000,35,-453000,Cobb County,Cobb County-St. Louis County-MO
2742,Cobb County-Richland County-SC-1819,"Richland County, SC",1819,2018,2019,100,2505000,76,2924000,24,-419000,Cobb County,Cobb County-Richland County-SC
2743,Cobb County-Travis County-TX-1819,"Travis County, TX",1819,2018,2019,94,3926000,124,4846000,-30,-920000,Cobb County,Cobb County-Travis County-TX
2744,Cobb County-Knox County-TN-1819,"Knox County, TN",1819,2018,2019,82,2770000,86,2835000,-4,-65000,Cobb County,Cobb County-Knox County-TN
2745,Cobb County-Leon County-FL-1819,"Leon County, FL",1819,2018,2019,83,3092000,43,1116000,40,1976000,Cobb County,Cobb County-Leon County-FL
2746,Cobb County-Lowndes County-GA-1819,"Lowndes County, GA",1819,2018,2019,76,1814000,31,745000,45,1069000,Cobb County,Cobb County-Lowndes County-GA
2747,Cobb County-Marion County-IN-1819,"Marion County, IN",1819,2018,2019,91,1727000,50,1330000,41,397000,Cobb County,Cobb County-Marion County-IN
2748,Cobb County-Middlesex County-MA-1819,"Middlesex County, MA",1819,2018,2019,96,3511000,69,2933000,27,578000,Cobb County,Cobb County-Middlesex County-MA
2749,Cobb County-Cuyahoga County-OH-1819,"Cuyahoga County, OH",1819,2018,2019,90,2689000,56,1840000,34,849000,Cobb County,Cobb County-Cuyahoga County-OH
2750,Cobb County-Montgomery County-AL-1819,"Montgomery County, AL",1819,2018,2019,77,2091000,50,1623000,27,468000,Cobb County,Cobb County-Montgomery County-AL
2751,Cobb County-Madison County-AL-1819,"Madison County, AL",1819,2018,2019,74,3077000,74,2725000,0,352000,Cobb County,Cobb County-Madison County-AL
2752,Cobb County-Walton County-GA-1819,"Walton County, GA",1819,2018,2019,78,3501000,65,1592000,13,1909000,Cobb County,Cobb County-Walton County-GA
2753,Cobb County-Philadelphia County-PA-1819,"Philadelphia County, PA",1819,2018,2019,82,1635000,50,1067000,32,568000,Cobb County,Cobb County-Philadelphia County-PA
2754,Cobb County-Hudson County-NJ-1819,"Hudson County, NJ",1819,2018,2019,66,3935000,38,1664000,28,2271000,Cobb County,Cobb County-Hudson County-NJ
2755,Cobb County-Allegheny County-PA-1819,"Allegheny County, PA",1819,2018,2019,88,2921000,44,1818000,44,1103000,Cobb County,Cobb County-Allegheny County-PA
2756,Cobb County-Bay County-FL-1819,"Bay County, FL",1819,2018,2019,89,2050000,80,4816000,9,-2766000,Cobb County,Cobb County-Bay County-FL
2757,Cobb County-Lee County-FL-1819,"Lee County, FL",1819,2018,2019,78,2457000,111,6253000,-33,-3796000,Cobb County,Cobb County-Lee County-FL
2758,Cobb County-District of Columbia-DC-1819,"District of Columbia, DC",1819,2018,2019,65,2916000,55,2695000,10,221000,Cobb County,Cobb County-District of Columbia-DC
2759,Cobb County-Columbia County-GA-1819,"Columbia County, GA",1819,2018,2019,82,2497000,86,3749000,-4,-1252000,Cobb County,Cobb County-Columbia County-GA
2760,Cobb County-Gordon County-GA-1819,"Gordon County, GA",1819,2018,2019,73,1920000,85,2827000,-12,-907000,Cobb County,Cobb County-Gordon County-GA
2761,Cobb County-Pickens County-GA-1819,"Pickens County, GA",1819,2018,2019,68,2764000,187,6774000,-119,-4010000,Cobb County,Cobb County-Pickens County-GA
2762,Cobb County-Polk County-GA-1819,"Polk County, GA",1819,2018,2019,70,2108000,165,4036000,-95,-1928000,Cobb County,Cobb County-Polk County-GA
2763,Cobb County-Guilford County-NC-1819,"Guilford County, NC",1819,2018,2019,71,2267000,54,1732000,17,535000,Cobb County,Cobb County-Guilford County-NC
2764,Cobb County-Polk County-FL-1819,"Polk County, FL",1819,2018,2019,76,1879000,85,2260000,-9,-381000,Cobb County,Cobb County-Polk County-FL
2765,Cobb County-Shelby County-AL-1819,"Shelby County, AL",1819,2018,2019,97,3743000,44,2106000,53,1637000,Cobb County,Cobb County-Shelby County-AL
2766,Cobb County-Montgomery County-MD-1819,"Montgomery County, MD",1819,2018,2019,76,2281000,88,3724000,-12,-1443000,Cobb County,Cobb County-Montgomery County-MD
2767,Cobb County-Escambia County-FL-1819,"Escambia County, FL",1819,2018,2019,70,1805000,88,3301000,-18,-1496000,Cobb County,Cobb County-Escambia County-FL
2768,Cobb County-Denton County-TX-1819,"Denton County, TX",1819,2018,2019,85,4794000,80,5588000,5,-794000,Cobb County,Cobb County-Denton County-TX
2769,Cobb County-Brevard County-FL-1819,"Brevard County, FL",1819,2018,2019,73,2706000,97,4252000,-24,-1546000,Cobb County,Cobb County-Brevard County-FL
2770,Cobb County-Essex County-NJ-1819,"Essex County, NJ",1819,2018,2019,77,6113000,42,978000,35,5135000,Cobb County,Cobb County-Essex County-NJ
2771,Cobb County-Mobile County-AL-1819,"Mobile County, AL",1819,2018,2019,73,1439000,37,949000,36,490000,Cobb County,Cobb County-Mobile County-AL
2772,Cobb County-Spalding County-GA-1819,"Spalding County, GA",1819,2018,2019,64,2257000,71,2878000,-7,-621000,Cobb County,Cobb County-Spalding County-GA
2773,Cobb County-Whitfield County-GA-1819,"Whitfield County, GA",1819,2018,2019,65,2957000,50,1252000,15,1705000,Cobb County,Cobb County-Whitfield County-GA
2774,Cobb County-Suffolk County-NY-1819,"Suffolk County, NY",1819,2018,2019,73,2460000,42,1269000,31,1191000,Cobb County,Cobb County-Suffolk County-NY
2775,Cobb County-Hamilton County-OH-1819,"Hamilton County, OH",1819,2018,2019,68,2238000,34,1573000,34,665000,Cobb County,Cobb County-Hamilton County-OH
2776,Cobb County-Alameda County-CA-1819,"Alameda County, CA",1819,2018,2019,68,2795000,64,3288000,4,-493000,Cobb County,Cobb County-Alameda County-CA
2777,Cobb County-Jefferson County-KY-1819,"Jefferson County, KY",1819,2018,2019,62,4416000,60,2503000,2,1913000,Cobb County,Cobb County-Jefferson County-KY
2778,Cobb County-Orleans Parish-LA-1819,"Orleans Parish, LA",1819,2018,2019,63,1610000,50,1002000,13,608000,Cobb County,Cobb County-Orleans Parish-LA
2779,Cobb County-Nassau County-NY-1819,"Nassau County, NY",1819,2018,2019,61,2309000,44,1548000,17,761000,Cobb County,Cobb County-Nassau County-NY
2780,Cobb County-Middlesex County-NJ-1819,"Middlesex County, NJ",1819,2018,2019,75,2501000,42,1800000,33,701000,Cobb County,Cobb County-Middlesex County-NJ
2781,Cobb County-Riverside County-CA-1819,"Riverside County, CA",1819,2018,2019,71,2100000,42,1493000,29,607000,Cobb County,Cobb County-Riverside County-CA
2782,Cobb County-Fort Bend County-TX-1819,"Fort Bend County, TX",1819,2018,2019,83,3634000,63,2194000,20,1440000,Cobb County,Cobb County-Fort Bend County-TX
2783,Cobb County-Milwaukee County-WI-1819,"Milwaukee County, WI",1819,2018,2019,68,2774000,39,1072000,29,1702000,Cobb County,Cobb County-Milwaukee County-WI
2784,Cobb County-Volusia County-FL-1819,"Volusia County, FL",1819,2018,2019,50,2114000,76,3099000,-26,-985000,Cobb County,Cobb County-Volusia County-FL
2785,Cobb County-Hennepin County-MN-1819,"Hennepin County, MN",1819,2018,2019,80,5105000,58,3298000,22,1807000,Cobb County,Cobb County-Hennepin County-MN
2786,Cobb County-El Paso County-CO-1819,"El Paso County, CO",1819,2018,2019,58,1702000,51,1280000,7,422000,Cobb County,Cobb County-El Paso County-CO
2787,Cobb County-Baltimore city-MD-1819,"Baltimore city, MD",1819,2018,2019,44,1630000,36,961000,8,669000,Cobb County,Cobb County-Baltimore city-MD
2788,Cobb County-Prince William County-VA-1819,"Prince William County, VA",1819,2018,2019,58,2120000,46,1072000,12,1048000,Cobb County,Cobb County-Prince William County-VA
2789,Cobb County-Virginia Beach city-VA-1819,"Virginia Beach city, VA",1819,2018,2019,80,1474000,36,759000,44,715000,Cobb County,Cobb County-Virginia Beach city-VA
2790,Cobb County-Arapahoe County-CO-1819,"Arapahoe County, CO",1819,2018,2019,72,2429000,68,2409000,4,20000,Cobb County,Cobb County-Arapahoe County-CO
2791,Cobb County-Glynn County-GA-1819,"Glynn County, GA",1819,2018,2019,51,1850000,101,9215000,-50,-7365000,Cobb County,Cobb County-Glynn County-GA
2792,Cobb County-Jefferson Parish-LA-1819,"Jefferson Parish, LA",1819,2018,2019,64,1517000,36,991000,28,526000,Cobb County,Cobb County-Jefferson Parish-LA
2793,Cobb County-Bulloch County-GA-1819,"Bulloch County, GA",1819,2018,2019,45,900000,44,1134000,1,-234000,Cobb County,Cobb County-Bulloch County-GA
2794,Cobb County-Rutherford County-TN-1819,"Rutherford County, TN",1819,2018,2019,44,1502000,55,2257000,-11,-755000,Cobb County,Cobb County-Rutherford County-TN
2795,Cobb County-Barrow County-GA-1819,"Barrow County, GA",1819,2018,2019,51,1347000,78,2462000,-27,-1115000,Cobb County,Cobb County-Barrow County-GA
2796,Cobb County-Denver County-CO-1819,"Denver County, CO",1819,2018,2019,43,2036000,70,3391000,-27,-1355000,Cobb County,Cobb County-Denver County-CO
2797,Cobb County-Osceola County-FL-1819,"Osceola County, FL",1819,2018,2019,48,692000,58,1474000,-10,-782000,Cobb County,Cobb County-Osceola County-FL
2798,Cobb County-Cumberland County-NC-1819,"Cumberland County, NC",1819,2018,2019,47,1213000,36,772000,11,441000,Cobb County,Cobb County-Cumberland County-NC
2799,Cobb County-Beaufort County-SC-1819,"Beaufort County, SC",1819,2018,2019,46,2144000,145,10525000,-99,-8381000,Cobb County,Cobb County-Beaufort County-SC
2800,Cobb County-Gilmer County-GA-1819,"Gilmer County, GA",1819,2018,2019,36,1235000,80,3312000,-44,-2077000,Cobb County,Cobb County-Gilmer County-GA
2801,Cobb County-Buncombe County-NC-1819,"Buncombe County, NC",1819,2018,2019,49,1407000,52,2965000,-3,-1558000,Cobb County,Cobb County-Buncombe County-NC
2802,Cobb County-Marion County-FL-1819,"Marion County, FL",1819,2018,2019,47,1447000,39,1080000,8,367000,Cobb County,Cobb County-Marion County-FL
2803,Cobb County-Pasco County-FL-1819,"Pasco County, FL",1819,2018,2019,44,1294000,86,3709000,-42,-2415000,Cobb County,Cobb County-Pasco County-FL
2804,Cobb County-Williamson County-TN-1819,"Williamson County, TN",1819,2018,2019,58,3121000,64,5047000,-6,-1926000,Cobb County,Cobb County-Williamson County-TN
2805,Cobb County-Okaloosa County-FL-1819,"Okaloosa County, FL",1819,2018,2019,41,1371000,55,4453000,-14,-3082000,Cobb County,Cobb County-Okaloosa County-FL
2806,Cobb County-Durham County-NC-1819,"Durham County, NC",1819,2018,2019,39,1258000,45,1942000,-6,-684000,Cobb County,Cobb County-Durham County-NC
2807,Cobb County-Collier County-FL-1819,"Collier County, FL",1819,2018,2019,48,2149000,57,3987000,-9,-1838000,Cobb County,Cobb County-Collier County-FL
2808,Cobb County-Honolulu County-HI-1819,"Honolulu County, HI",1819,2018,2019,41,1830000,48,1267000,-7,563000,Cobb County,Cobb County-Honolulu County-HI
2809,Cobb County-Montgomery County-TN-1819,"Montgomery County, TN",1819,2018,2019,35,1042000,43,900000,-8,142000,Cobb County,Cobb County-Montgomery County-TN
2810,Cobb County-Manatee County-FL-1819,"Manatee County, FL",1819,2018,2019,36,1278000,73,4223000,-37,-2945000,Cobb County,Cobb County-Manatee County-FL
2811,Cobb County-Fannin County-GA-1819,"Fannin County, GA",1819,2018,2019,28,797000,60,3566000,-32,-2769000,Cobb County,Cobb County-Fannin County-GA
2812,Cobb County-Haralson County-GA-1819,"Haralson County, GA",1819,2018,2019,38,1173000,49,1864000,-11,-691000,Cobb County,Cobb County-Haralson County-GA
2813,Cobb County-Pierce County-WA-1819,"Pierce County, WA",1819,2018,2019,44,1722000,31,776000,13,946000,Cobb County,Cobb County-Pierce County-WA
2814,Cobb County-Contra Costa County-CA-1819,"Contra Costa County, CA",1819,2018,2019,56,1842000,34,1371000,22,471000,Cobb County,Cobb County-Contra Costa County-CA
2815,Cobb County-Troup County-GA-1819,"Troup County, GA",1819,2018,2019,32,907000,35,926000,-3,-19000,Cobb County,Cobb County-Troup County-GA
2816,Cobb County-Arlington County-VA-1819,"Arlington County, VA",1819,2018,2019,39,2400000,38,1742000,1,658000,Cobb County,Cobb County-Arlington County-VA
2818,DeKalb County-Fulton County-GA-1819,"Fulton County, GA",1819,2018,2019,13787,612146000,13371,593000000,416,19146000,DeKalb County,DeKalb County-Fulton County-GA
2819,DeKalb County-Gwinnett County-GA-1819,"Gwinnett County, GA",1819,2018,2019,8059,202314000,11547,261314000,-3488,-59000000,DeKalb County,DeKalb County-Gwinnett County-GA
2820,DeKalb County-Cobb County-GA-1819,"Cobb County, GA",1819,2018,2019,2897,105810000,3341,127705000,-444,-21895000,DeKalb County,DeKalb County-Cobb County-GA
2821,DeKalb County-Clayton County-GA-1819,"Clayton County, GA",1819,2018,2019,2659,35185000,3315,44032000,-656,-8847000,DeKalb County,DeKalb County-Clayton County-GA
2822,DeKalb County-Rockdale County-GA-1819,"Rockdale County, GA",1819,2018,2019,1190,20291000,2027,36977000,-837,-16686000,DeKalb County,DeKalb County-Rockdale County-GA
2823,DeKalb County-Henry County-GA-1819,"Henry County, GA",1819,2018,2019,1095,21598000,1786,35938000,-691,-14340000,DeKalb County,DeKalb County-Henry County-GA
2824,DeKalb County-Newton County-GA-1819,"Newton County, GA",1819,2018,2019,764,12634000,1245,21084000,-481,-8450000,DeKalb County,DeKalb County-Newton County-GA
2825,DeKalb County-Los Angeles County-CA-1819,"Los Angeles County, CA",1819,2018,2019,445,16091000,369,14538000,76,1553000,DeKalb County,DeKalb County-Los Angeles County-CA
2826,DeKalb County-Cook County-IL-1819,"Cook County, IL",1819,2018,2019,455,21835000,355,15284000,100,6551000,DeKalb County,DeKalb County-Cook County-IL
2827,DeKalb County-Forsyth County-GA-1819,"Forsyth County, GA",1819,2018,2019,387,16677000,831,32653000,-444,-15976000,DeKalb County,DeKalb County-Forsyth County-GA
2828,DeKalb County-Broward County-FL-1819,"Broward County, FL",1819,2018,2019,427,10832000,264,8934000,163,1898000,DeKalb County,DeKalb County-Broward County-FL
2829,DeKalb County-Kings County-NY-1819,"Kings County, NY",1819,2018,2019,350,10648000,174,5882000,176,4766000,DeKalb County,DeKalb County-Kings County-NY
2830,DeKalb County-Miami-Dade County-FL-1819,"Miami-Dade County, FL",1819,2018,2019,375,9694000,192,6993000,183,2701000,DeKalb County,DeKalb County-Miami-Dade County-FL
2831,DeKalb County-Cherokee County-GA-1819,"Cherokee County, GA",1819,2018,2019,288,11419000,431,17957000,-143,-6538000,DeKalb County,DeKalb County-Cherokee County-GA
2832,DeKalb County-Douglas County-GA-1819,"Douglas County, GA",1819,2018,2019,314,7820000,468,9549000,-154,-1729000,DeKalb County,DeKalb County-Douglas County-GA
2833,DeKalb County-Clarke County-GA-1819,"Clarke County, GA",1819,2018,2019,270,6548000,166,4788000,104,1760000,DeKalb County,DeKalb County-Clarke County-GA
2834,DeKalb County-Mecklenburg County-NC-1819,"Mecklenburg County, NC",1819,2018,2019,274,13721000,314,12019000,-40,1702000,DeKalb County,DeKalb County-Mecklenburg County-NC
2835,DeKalb County-Chatham County-GA-1819,"Chatham County, GA",1819,2018,2019,276,7779000,173,5596000,103,2183000,DeKalb County,DeKalb County-Chatham County-GA
2836,DeKalb County-Harris County-TX-1819,"Harris County, TX",1819,2018,2019,255,11253000,273,9894000,-18,1359000,DeKalb County,DeKalb County-Harris County-TX
2837,DeKalb County-Orange County-FL-1819,"Orange County, FL",1819,2018,2019,261,6783000,208,7281000,53,-498000,DeKalb County,DeKalb County-Orange County-FL
2838,DeKalb County-Duval County-FL-1819,"Duval County, FL",1819,2018,2019,275,8045000,236,7064000,39,981000,DeKalb County,DeKalb County-Duval County-FL
2839,DeKalb County-Fayette County-GA-1819,"Fayette County, GA",1819,2018,2019,228,12818000,236,10705000,-8,2113000,DeKalb County,DeKalb County-Fayette County-GA
2840,DeKalb County-New York County-NY-1819,"New York County, NY",1819,2018,2019,183,12063000,167,12444000,16,-381000,DeKalb County,DeKalb County-New York County-NY
2841,DeKalb County-Davidson County-TN-1819,"Davidson County, TN",1819,2018,2019,219,7997000,219,7798000,0,199000,DeKalb County,DeKalb County-Davidson County-TN
2842,DeKalb County-Jefferson County-AL-1819,"Jefferson County, AL",1819,2018,2019,235,7671000,161,5267000,74,2404000,DeKalb County,DeKalb County-Jefferson County-AL
2843,DeKalb County-Shelby County-TN-1819,"Shelby County, TN",1819,2018,2019,217,4885000,134,3322000,83,1563000,DeKalb County,DeKalb County-Shelby County-TN
2844,DeKalb County-Hillsborough County-FL-1819,"Hillsborough County, FL",1819,2018,2019,189,4865000,180,6623000,9,-1758000,DeKalb County,DeKalb County-Hillsborough County-FL
2845,DeKalb County-Hall County-GA-1819,"Hall County, GA",1819,2018,2019,195,7363000,240,6665000,-45,698000,DeKalb County,DeKalb County-Hall County-GA
2846,DeKalb County-Queens County-NY-1819,"Queens County, NY",1819,2018,2019,196,5822000,118,2299000,78,3523000,DeKalb County,DeKalb County-Queens County-NY
2847,DeKalb County-Maricopa County-AZ-1819,"Maricopa County, AZ",1819,2018,2019,205,6955000,218,10038000,-13,-3083000,DeKalb County,DeKalb County-Maricopa County-AZ
2848,DeKalb County-Muscogee County-GA-1819,"Muscogee County, GA",1819,2018,2019,168,4451000,166,4209000,2,242000,DeKalb County,DeKalb County-Muscogee County-GA
2849,DeKalb County-Walton County-GA-1819,"Walton County, GA",1819,2018,2019,191,4721000,333,7789000,-142,-3068000,DeKalb County,DeKalb County-Walton County-GA
2850,DeKalb County-Dallas County-TX-1819,"Dallas County, TX",1819,2018,2019,172,9575000,216,10842000,-44,-1267000,DeKalb County,DeKalb County-Dallas County-TX
2851,DeKalb County-Richmond County-GA-1819,"Richmond County, GA",1819,2018,2019,172,3447000,135,3525000,37,-78000,DeKalb County,DeKalb County-Richmond County-GA
2852,DeKalb County-Coweta County-GA-1819,"Coweta County, GA",1819,2018,2019,144,5074000,150,5507000,-6,-433000,DeKalb County,DeKalb County-Coweta County-GA
2853,DeKalb County-Paulding County-GA-1819,"Paulding County, GA",1819,2018,2019,159,4075000,249,5429000,-90,-1354000,DeKalb County,DeKalb County-Paulding County-GA
2854,DeKalb County-Palm Beach County-FL-1819,"Palm Beach County, FL",1819,2018,2019,146,10143000,145,6318000,1,3825000,DeKalb County,DeKalb County-Palm Beach County-FL
2855,DeKalb County-Bibb County-GA-1819,"Bibb County, GA",1819,2018,2019,158,3278000,125,2463000,33,815000,DeKalb County,DeKalb County-Bibb County-GA
2856,DeKalb County-San Diego County-CA-1819,"San Diego County, CA",1819,2018,2019,143,6031000,179,10079000,-36,-4048000,DeKalb County,DeKalb County-San Diego County-CA
2857,DeKalb County-King County-WA-1819,"King County, WA",1819,2018,2019,139,8290000,243,11806000,-104,-3516000,DeKalb County,DeKalb County-King County-WA
2858,DeKalb County-District of Columbia-DC-1819,"District of Columbia, DC",1819,2018,2019,115,7133000,104,6543000,11,590000,DeKalb County,DeKalb County-District of Columbia-DC
2859,DeKalb County-Wake County-NC-1819,"Wake County, NC",1819,2018,2019,106,5496000,137,5553000,-31,-57000,DeKalb County,DeKalb County-Wake County-NC
2860,DeKalb County-Philadelphia County-PA-1819,"Philadelphia County, PA",1819,2018,2019,138,4574000,98,2764000,40,1810000,DeKalb County,DeKalb County-Philadelphia County-PA
2861,DeKalb County-Fairfax County-VA-1819,"Fairfax County, VA",1819,2018,2019,141,7406000,109,5693000,32,1713000,DeKalb County,DeKalb County-Fairfax County-VA
2862,DeKalb County-Franklin County-OH-1819,"Franklin County, OH",1819,2018,2019,127,2680000,188,3778000,-61,-1098000,DeKalb County,DeKalb County-Franklin County-OH
2863,DeKalb County-Carroll County-GA-1819,"Carroll County, GA",1819,2018,2019,117,2655000,82,1361000,35,1294000,DeKalb County,DeKalb County-Carroll County-GA
2864,DeKalb County-Wayne County-MI-1819,"Wayne County, MI",1819,2018,2019,148,3246000,115,2179000,33,1067000,DeKalb County,DeKalb County-Wayne County-MI
2865,DeKalb County-Bronx County-NY-1819,"Bronx County, NY",1819,2018,2019,132,2288000,66,1444000,66,844000,DeKalb County,DeKalb County-Bronx County-NY
2866,DeKalb County-Greenville County-SC-1819,"Greenville County, SC",1819,2018,2019,110,5008000,105,4162000,5,846000,DeKalb County,DeKalb County-Greenville County-SC
2867,DeKalb County-Clark County-NV-1819,"Clark County, NV",1819,2018,2019,129,3317000,129,2407000,0,910000,DeKalb County,DeKalb County-Clark County-NV
2868,DeKalb County-Leon County-FL-1819,"Leon County, FL",1819,2018,2019,99,2781000,49,1155000,50,1626000,DeKalb County,DeKalb County-Leon County-FL
2869,DeKalb County-Montgomery County-MD-1819,"Montgomery County, MD",1819,2018,2019,107,5168000,109,4249000,-2,919000,DeKalb County,DeKalb County-Montgomery County-MD
2870,DeKalb County-Charleston County-SC-1819,"Charleston County, SC",1819,2018,2019,98,4099000,106,6782000,-8,-2683000,DeKalb County,DeKalb County-Charleston County-SC
2871,DeKalb County-Richland County-SC-1819,"Richland County, SC",1819,2018,2019,110,2867000,81,1667000,29,1200000,DeKalb County,DeKalb County-Richland County-SC
2872,DeKalb County-Alameda County-CA-1819,"Alameda County, CA",1819,2018,2019,135,5656000,104,6517000,31,-861000,DeKalb County,DeKalb County-Alameda County-CA
2873,DeKalb County-Santa Clara County-CA-1819,"Santa Clara County, CA",1819,2018,2019,111,9662000,137,9323000,-26,339000,DeKalb County,DeKalb County-Santa Clara County-CA
2874,DeKalb County-Cuyahoga County-OH-1819,"Cuyahoga County, OH",1819,2018,2019,138,3466000,89,2555000,49,911000,DeKalb County,DeKalb County-Cuyahoga County-OH
2875,DeKalb County-Essex County-NJ-1819,"Essex County, NJ",1819,2018,2019,125,4143000,73,947000,52,3196000,DeKalb County,DeKalb County-Essex County-NJ
2876,DeKalb County-Durham County-NC-1819,"Durham County, NC",1819,2018,2019,100,4765000,73,2940000,27,1825000,DeKalb County,DeKalb County-Durham County-NC
2877,DeKalb County-St. Louis County-MO-1819,"St. Louis County, MO",1819,2018,2019,113,4792000,69,2561000,44,2231000,DeKalb County,DeKalb County-St. Louis County-MO
2878,DeKalb County-Allegheny County-PA-1819,"Allegheny County, PA",1819,2018,2019,102,3279000,96,3224000,6,55000,DeKalb County,DeKalb County-Allegheny County-PA
2879,DeKalb County-Pinellas County-FL-1819,"Pinellas County, FL",1819,2018,2019,97,3521000,108,7095000,-11,-3574000,DeKalb County,DeKalb County-Pinellas County-FL
2880,DeKalb County-Prince George's County-MD-1819,"Prince George's County, MD",1819,2018,2019,110,2909000,90,2223000,20,686000,DeKalb County,DeKalb County-Prince George's County-MD
2881,DeKalb County-Marion County-IN-1819,"Marion County, IN",1819,2018,2019,103,2774000,118,1966000,-15,808000,DeKalb County,DeKalb County-Marion County-IN
2882,DeKalb County-Hamilton County-TN-1819,"Hamilton County, TN",1819,2018,2019,98,2617000,105,3405000,-7,-788000,DeKalb County,DeKalb County-Hamilton County-TN
2883,DeKalb County-Houston County-GA-1819,"Houston County, GA",1819,2018,2019,98,2297000,81,1382000,17,915000,DeKalb County,DeKalb County-Houston County-GA
2884,DeKalb County-Dougherty County-GA-1819,"Dougherty County, GA",1819,2018,2019,109,1943000,72,785000,37,1158000,DeKalb County,DeKalb County-Dougherty County-GA
2885,DeKalb County-Hamilton County-OH-1819,"Hamilton County, OH",1819,2018,2019,103,3410000,105,2670000,-2,740000,DeKalb County,DeKalb County-Hamilton County-OH
2886,DeKalb County-Travis County-TX-1819,"Travis County, TX",1819,2018,2019,93,4963000,119,7029000,-26,-2066000,DeKalb County,DeKalb County-Travis County-TX
2887,DeKalb County-Denver County-CO-1819,"Denver County, CO",1819,2018,2019,82,4285000,145,6700000,-63,-2415000,DeKalb County,DeKalb County-Denver County-CO
2888,DeKalb County-Suffolk County-MA-1819,"Suffolk County, MA",1819,2018,2019,82,2895000,86,2771000,-4,124000,DeKalb County,DeKalb County-Suffolk County-MA
2889,DeKalb County-Baltimore city-MD-1819,"Baltimore city, MD",1819,2018,2019,91,3306000,45,1862000,46,1444000,DeKalb County,DeKalb County-Baltimore city-MD
2890,DeKalb County-Oakland County-MI-1819,"Oakland County, MI",1819,2018,2019,83,5070000,54,1910000,29,3160000,DeKalb County,DeKalb County-Oakland County-MI
2891,DeKalb County-Milwaukee County-WI-1819,"Milwaukee County, WI",1819,2018,2019,97,2484000,68,952000,29,1532000,DeKalb County,DeKalb County-Milwaukee County-WI
2892,DeKalb County-Montgomery County-AL-1819,"Montgomery County, AL",1819,2018,2019,92,1804000,52,846000,40,958000,DeKalb County,DeKalb County-Montgomery County-AL
2893,DeKalb County-Barrow County-GA-1819,"Barrow County, GA",1819,2018,2019,91,1863000,156,3576000,-65,-1713000,DeKalb County,DeKalb County-Barrow County-GA
2894,DeKalb County-Lowndes County-GA-1819,"Lowndes County, GA",1819,2018,2019,85,1168000,43,739000,42,429000,DeKalb County,DeKalb County-Lowndes County-GA
2895,DeKalb County-Hennepin County-MN-1819,"Hennepin County, MN",1819,2018,2019,65,3012000,99,3981000,-34,-969000,DeKalb County,DeKalb County-Hennepin County-MN
2896,DeKalb County-Orleans Parish-LA-1819,"Orleans Parish, LA",1819,2018,2019,84,3351000,79,2442000,5,909000,DeKalb County,DeKalb County-Orleans Parish-LA
2897,DeKalb County-Knox County-TN-1819,"Knox County, TN",1819,2018,2019,83,2428000,94,1563000,-11,865000,DeKalb County,DeKalb County-Knox County-TN
2898,DeKalb County-Lee County-AL-1819,"Lee County, AL",1819,2018,2019,79,2187000,50,1750000,29,437000,DeKalb County,DeKalb County-Lee County-AL
2899,DeKalb County-Jefferson County-KY-1819,"Jefferson County, KY",1819,2018,2019,83,2517000,130,2412000,-47,105000,DeKalb County,DeKalb County-Jefferson County-KY
2900,DeKalb County-Tarrant County-TX-1819,"Tarrant County, TX",1819,2018,2019,91,1866000,79,2612000,12,-746000,DeKalb County,DeKalb County-Tarrant County-TX
2901,DeKalb County-Seminole County-FL-1819,"Seminole County, FL",1819,2018,2019,75,2430000,43,2068000,32,362000,DeKalb County,DeKalb County-Seminole County-FL
2902,DeKalb County-Middlesex County-MA-1819,"Middlesex County, MA",1819,2018,2019,74,3435000,75,4673000,-1,-1238000,DeKalb County,DeKalb County-Middlesex County-MA
2903,DeKalb County-Escambia County-FL-1819,"Escambia County, FL",1819,2018,2019,79,2026000,61,2363000,18,-337000,DeKalb County,DeKalb County-Escambia County-FL
2904,DeKalb County-Guilford County-NC-1819,"Guilford County, NC",1819,2018,2019,73,1743000,50,1211000,23,532000,DeKalb County,DeKalb County-Guilford County-NC
2905,DeKalb County-Bexar County-TX-1819,"Bexar County, TX",1819,2018,2019,81,4631000,70,2158000,11,2473000,DeKalb County,DeKalb County-Bexar County-TX
2906,DeKalb County-Alachua County-FL-1819,"Alachua County, FL",1819,2018,2019,59,2316000,68,2121000,-9,195000,DeKalb County,DeKalb County-Alachua County-FL
2907,DeKalb County-East Baton Rouge Parish-LA-1819,"East Baton Rouge Parish, LA",1819,2018,2019,71,2332000,52,1007000,19,1325000,DeKalb County,DeKalb County-East Baton Rouge Parish-LA
2908,DeKalb County-Suffolk County-NY-1819,"Suffolk County, NY",1819,2018,2019,70,1370000,41,1280000,29,90000,DeKalb County,DeKalb County-Suffolk County-NY
2909,DeKalb County-Orange County-CA-1819,"Orange County, CA",1819,2018,2019,81,5040000,45,4803000,36,237000,DeKalb County,DeKalb County-Orange County-CA
2910,DeKalb County-Lee County-FL-1819,"Lee County, FL",1819,2018,2019,60,2166000,60,3790000,0,-1624000,DeKalb County,DeKalb County-Lee County-FL
2911,DeKalb County-Fairfield County-CT-1819,"Fairfield County, CT",1819,2018,2019,87,3480000,51,3666000,36,-186000,DeKalb County,DeKalb County-Fairfield County-CT
2912,DeKalb County-San Francisco County-CA-1819,"San Francisco County, CA",1819,2018,2019,51,4360000,49,3937000,2,423000,DeKalb County,DeKalb County-San Francisco County-CA
2913,DeKalb County-Nassau County-NY-1819,"Nassau County, NY",1819,2018,2019,72,2340000,33,1800000,39,540000,DeKalb County,DeKalb County-Nassau County-NY
2914,DeKalb County-Collin County-TX-1819,"Collin County, TX",1819,2018,2019,80,4384000,96,4656000,-16,-272000,DeKalb County,DeKalb County-Collin County-TX
2915,DeKalb County-Mobile County-AL-1819,"Mobile County, AL",1819,2018,2019,74,1193000,49,1027000,25,166000,DeKalb County,DeKalb County-Mobile County-AL
2916,DeKalb County-New Haven County-CT-1819,"New Haven County, CT",1819,2018,2019,77,5501000,49,1339000,28,4162000,DeKalb County,DeKalb County-New Haven County-CT
2917,DeKalb County-Glynn County-GA-1819,"Glynn County, GA",1819,2018,2019,69,1675000,89,3716000,-20,-2041000,DeKalb County,DeKalb County-Glynn County-GA
2918,DeKalb County-Hudson County-NJ-1819,"Hudson County, NJ",1819,2018,2019,81,4845000,47,3486000,34,1359000,DeKalb County,DeKalb County-Hudson County-NJ
2919,DeKalb County-Madison County-AL-1819,"Madison County, AL",1819,2018,2019,54,1919000,57,1083000,-3,836000,DeKalb County,DeKalb County-Madison County-AL
2920,DeKalb County-Bartow County-GA-1819,"Bartow County, GA",1819,2018,2019,69,1611000,80,2060000,-11,-449000,DeKalb County,DeKalb County-Bartow County-GA
2921,DeKalb County-Hartford County-CT-1819,"Hartford County, CT",1819,2018,2019,68,2874000,59,2105000,9,769000,DeKalb County,DeKalb County-Hartford County-CT
2922,DeKalb County-Jackson County-GA-1819,"Jackson County, GA",1819,2018,2019,57,1495000,71,2397000,-14,-902000,DeKalb County,DeKalb County-Jackson County-GA
2923,DeKalb County-Spalding County-GA-1819,"Spalding County, GA",1819,2018,2019,62,1309000,104,1726000,-42,-417000,DeKalb County,DeKalb County-Spalding County-GA
2924,DeKalb County-Arapahoe County-CO-1819,"Arapahoe County, CO",1819,2018,2019,55,1695000,60,3021000,-5,-1326000,DeKalb County,DeKalb County-Arapahoe County-CO
2925,DeKalb County-Troup County-GA-1819,"Troup County, GA",1819,2018,2019,59,1085000,45,671000,14,414000,DeKalb County,DeKalb County-Troup County-GA
2926,DeKalb County-Volusia County-FL-1819,"Volusia County, FL",1819,2018,2019,47,1828000,57,1569000,-10,259000,DeKalb County,DeKalb County-Volusia County-FL
2927,DeKalb County-Columbia County-GA-1819,"Columbia County, GA",1819,2018,2019,48,1879000,55,1642000,-7,237000,DeKalb County,DeKalb County-Columbia County-GA
2928,DeKalb County-Arlington County-VA-1819,"Arlington County, VA",1819,2018,2019,43,3473000,51,3167000,-8,306000,DeKalb County,DeKalb County-Arlington County-VA
2929,DeKalb County-Loudoun County-VA-1819,"Loudoun County, VA",1819,2018,2019,67,4316000,39,1999000,28,2317000,DeKalb County,DeKalb County-Loudoun County-VA
2930,DeKalb County-Brevard County-FL-1819,"Brevard County, FL",1819,2018,2019,46,1864000,46,1358000,0,506000,DeKalb County,DeKalb County-Brevard County-FL
2931,DeKalb County-Erie County-NY-1819,"Erie County, NY",1819,2018,2019,48,1183000,90,643000,-42,540000,DeKalb County,DeKalb County-Erie County-NY
2932,DeKalb County-Sacramento County-CA-1819,"Sacramento County, CA",1819,2018,2019,58,1231000,61,1311000,-3,-80000,DeKalb County,DeKalb County-Sacramento County-CA
2933,DeKalb County-Monroe County-NY-1819,"Monroe County, NY",1819,2018,2019,51,1367000,42,833000,9,534000,DeKalb County,DeKalb County-Monroe County-NY
2934,DeKalb County-Cumberland County-NC-1819,"Cumberland County, NC",1819,2018,2019,60,1201000,56,2302000,4,-1101000,DeKalb County,DeKalb County-Cumberland County-NC
2935,DeKalb County-Beaufort County-SC-1819,"Beaufort County, SC",1819,2018,2019,48,2674000,49,3666000,-1,-992000,DeKalb County,DeKalb County-Beaufort County-SC
2936,DeKalb County-Virginia Beach city-VA-1819,"Virginia Beach city, VA",1819,2018,2019,50,1276000,45,1997000,5,-721000,DeKalb County,DeKalb County-Virginia Beach city-VA
2937,DeKalb County-Baltimore County-MD-1819,"Baltimore County, MD",1819,2018,2019,46,1148000,73,1793000,-27,-645000,DeKalb County,DeKalb County-Baltimore County-MD
2938,DeKalb County-Richmond city-VA-1819,"Richmond city, VA",1819,2018,2019,41,1320000,36,2121000,5,-801000,DeKalb County,DeKalb County-Richmond city-VA
2939,DeKalb County-Polk County-FL-1819,"Polk County, FL",1819,2018,2019,49,1134000,50,1066000,-1,68000,DeKalb County,DeKalb County-Polk County-FL
2940,DeKalb County-Westchester County-NY-1819,"Westchester County, NY",1819,2018,2019,53,2078000,56,3389000,-3,-1311000,DeKalb County,DeKalb County-Westchester County-NY
2941,DeKalb County-Summit County-OH-1819,"Summit County, OH",1819,2018,2019,57,1087000,57,1124000,0,-37000,DeKalb County,DeKalb County-Summit County-OH
2942,DeKalb County-Multnomah County-OR-1819,"Multnomah County, OR",1819,2018,2019,37,1135000,45,2243000,-8,-1108000,DeKalb County,DeKalb County-Multnomah County-OR
2943,DeKalb County-DuPage County-IL-1819,"DuPage County, IL",1819,2018,2019,51,2236000,47,2063000,4,173000,DeKalb County,DeKalb County-DuPage County-IL
2944,DeKalb County-Buncombe County-NC-1819,"Buncombe County, NC",1819,2018,2019,43,1449000,62,3942000,-19,-2493000,DeKalb County,DeKalb County-Buncombe County-NC
2945,DeKalb County-San Mateo County-CA-1819,"San Mateo County, CA",1819,2018,2019,43,2786000,32,2065000,11,721000,DeKalb County,DeKalb County-San Mateo County-CA
2946,DeKalb County-Norfolk city-VA-1819,"Norfolk city, VA",1819,2018,2019,42,1395000,36,835000,6,560000,DeKalb County,DeKalb County-Norfolk city-VA
2947,DeKalb County-St. Johns County-FL-1819,"St. Johns County, FL",1819,2018,2019,42,1732000,49,2587000,-7,-855000,DeKalb County,DeKalb County-St. Johns County-FL
2948,DeKalb County-Baldwin County-GA-1819,"Baldwin County, GA",1819,2018,2019,46,841000,37,633000,9,208000,DeKalb County,DeKalb County-Baldwin County-GA
2949,DeKalb County-St. Louis city-MO-1819,"St. Louis city, MO",1819,2018,2019,39,1312000,25,950000,14,362000,DeKalb County,DeKalb County-St. Louis city-MO
2950,DeKalb County-St. Lucie County-FL-1819,"St. Lucie County, FL",1819,2018,2019,44,789000,36,1734000,8,-945000,DeKalb County,DeKalb County-St. Lucie County-FL
2951,DeKalb County-Jefferson Parish-LA-1819,"Jefferson Parish, LA",1819,2018,2019,37,720000,64,1171000,-27,-451000,DeKalb County,DeKalb County-Jefferson Parish-LA
2952,DeKalb County-Ramsey County-MN-1819,"Ramsey County, MN",1819,2018,2019,40,987000,73,1380000,-33,-393000,DeKalb County,DeKalb County-Ramsey County-MN
2953,DeKalb County-Shelby County-AL-1819,"Shelby County, AL",1819,2018,2019,32,1394000,40,1272000,-8,122000,DeKalb County,DeKalb County-Shelby County-AL
2954,DeKalb County-Aiken County-SC-1819,"Aiken County, SC",1819,2018,2019,33,926000,30,790000,3,136000,DeKalb County,DeKalb County-Aiken County-SC
2955,DeKalb County-Howard County-MD-1819,"Howard County, MD",1819,2018,2019,31,1060000,39,1338000,-8,-278000,DeKalb County,DeKalb County-Howard County-MD
2956,DeKalb County-Okaloosa County-FL-1819,"Okaloosa County, FL",1819,2018,2019,27,707000,34,1588000,-7,-881000,DeKalb County,DeKalb County-Okaloosa County-FL
2957,DeKalb County-Osceola County-FL-1819,"Osceola County, FL",1819,2018,2019,43,853000,34,594000,9,259000,DeKalb County,DeKalb County-Osceola County-FL
2959,Douglas County-Cobb County-GA-1819,"Cobb County, GA",1819,2018,2019,2779,48527000,1995,39439000,784,9088000,Douglas County,Douglas County-Cobb County-GA
2960,Douglas County-Fulton County-GA-1819,"Fulton County, GA",1819,2018,2019,1763,34342000,1491,32988000,272,1354000,Douglas County,Douglas County-Fulton County-GA
2961,Douglas County-Paulding County-GA-1819,"Paulding County, GA",1819,2018,2019,939,18344000,1169,24357000,-230,-6013000,Douglas County,Douglas County-Paulding County-GA
2962,Douglas County-Carroll County-GA-1819,"Carroll County, GA",1819,2018,2019,873,17424000,1288,29133000,-415,-11709000,Douglas County,Douglas County-Carroll County-GA
2963,Douglas County-DeKalb County-GA-1819,"DeKalb County, GA",1819,2018,2019,468,9549000,314,7820000,154,1729000,Douglas County,Douglas County-DeKalb County-GA
2964,Douglas County-Clayton County-GA-1819,"Clayton County, GA",1819,2018,2019,384,5640000,384,5131000,0,509000,Douglas County,Douglas County-Clayton County-GA
2965,Douglas County-Gwinnett County-GA-1819,"Gwinnett County, GA",1819,2018,2019,276,5771000,328,6707000,-52,-936000,Douglas County,Douglas County-Gwinnett County-GA
2966,Douglas County-Henry County-GA-1819,"Henry County, GA",1819,2018,2019,133,2306000,169,3198000,-36,-892000,Douglas County,Douglas County-Henry County-GA
2967,Douglas County-Broward County-FL-1819,"Broward County, FL",1819,2018,2019,91,1615000,53,1296000,38,319000,Douglas County,Douglas County-Broward County-FL
2968,Douglas County-Haralson County-GA-1819,"Haralson County, GA",1819,2018,2019,99,2217000,197,4429000,-98,-2212000,Douglas County,Douglas County-Haralson County-GA
2969,Douglas County-Coweta County-GA-1819,"Coweta County, GA",1819,2018,2019,73,1518000,194,5942000,-121,-4424000,Douglas County,Douglas County-Coweta County-GA
2970,Douglas County-Cherokee County-GA-1819,"Cherokee County, GA",1819,2018,2019,59,834000,80,2083000,-21,-1249000,Douglas County,Douglas County-Cherokee County-GA
2971,Douglas County-Fayette County-GA-1819,"Fayette County, GA",1819,2018,2019,57,1399000,100,4435000,-43,-3036000,Douglas County,Douglas County-Fayette County-GA
2972,Douglas County-Bartow County-GA-1819,"Bartow County, GA",1819,2018,2019,56,916000,69,1603000,-13,-687000,Douglas County,Douglas County-Bartow County-GA
2973,Douglas County-Rockdale County-GA-1819,"Rockdale County, GA",1819,2018,2019,54,966000,51,679000,3,287000,Douglas County,Douglas County-Rockdale County-GA
2975,Fayette County-Fulton County-GA-1819,"Fulton County, GA",1819,2018,2019,1180,41246000,958,39323000,222,1923000,Fayette County,Fayette County-Fulton County-GA
2976,Fayette County-Clayton County-GA-1819,"Clayton County, GA",1819,2018,2019,980,19601000,444,7851000,536,11750000,Fayette County,Fayette County-Clayton County-GA
2977,Fayette County-Coweta County-GA-1819,"Coweta County, GA",1819,2018,2019,922,33736000,1360,55524000,-438,-21788000,Fayette County,Fayette County-Coweta County-GA
2978,Fayette County-Henry County-GA-1819,"Henry County, GA",1819,2018,2019,428,16987000,264,7035000,164,9952000,Fayette County,Fayette County-Henry County-GA
2979,Fayette County-DeKalb County-GA-1819,"DeKalb County, GA",1819,2018,2019,236,10705000,228,12818000,8,-2113000,Fayette County,Fayette County-DeKalb County-GA
2980,Fayette County-Cobb County-GA-1819,"Cobb County, GA",1819,2018,2019,261,11367000,239,9504000,22,1863000,Fayette County,Fayette County-Cobb County-GA
2981,Fayette County-Gwinnett County-GA-1819,"Gwinnett County, GA",1819,2018,2019,187,6406000,134,3369000,53,3037000,Fayette County,Fayette County-Gwinnett County-GA
2982,Fayette County-Spalding County-GA-1819,"Spalding County, GA",1819,2018,2019,191,4435000,198,7623000,-7,-3188000,Fayette County,Fayette County-Spalding County-GA
2983,Fayette County-Los Angeles County-CA-1819,"Los Angeles County, CA",1819,2018,2019,124,7561000,48,2069000,76,5492000,Fayette County,Fayette County-Los Angeles County-CA
2984,Fayette County-Douglas County-GA-1819,"Douglas County, GA",1819,2018,2019,100,4435000,57,1399000,43,3036000,Fayette County,Fayette County-Douglas County-GA
2985,Fayette County-Cherokee County-GA-1819,"Cherokee County, GA",1819,2018,2019,38,1160000,80,3652000,-42,-2492000,Fayette County,Fayette County-Cherokee County-GA
2986,Fayette County-Meriwether County-GA-1819,"Meriwether County, GA",1819,2018,2019,42,2082000,84,3102000,-42,-1020000,Fayette County,Fayette County-Meriwether County-GA
2988,Forsyth County-Fulton County-GA-1819,"Fulton County, GA",1819,2018,2019,4753,223450000,2355,157137000,2398,66313000,Forsyth County,Forsyth County-Fulton County-GA
2989,Forsyth County-Gwinnett County-GA-1819,"Gwinnett County, GA",1819,2018,2019,2440,93656000,1267,44778000,1173,48878000,Forsyth County,Forsyth County-Gwinnett County-GA
2990,Forsyth County-Cobb County-GA-1819,"Cobb County, GA",1819,2018,2019,864,36194000,388,17081000,476,19113000,Forsyth County,Forsyth County-Cobb County-GA
2991,Forsyth County-DeKalb County-GA-1819,"DeKalb County, GA",1819,2018,2019,831,32653000,387,16677000,444,15976000,Forsyth County,Forsyth County-DeKalb County-GA
2992,Forsyth County-Hall County-GA-1819,"Hall County, GA",1819,2018,2019,545,19846000,695,33179000,-150,-13333000,Forsyth County,Forsyth County-Hall County-GA
2993,Forsyth County-Cherokee County-GA-1819,"Cherokee County, GA",1819,2018,2019,614,23179000,837,37399000,-223,-14220000,Forsyth County,Forsyth County-Cherokee County-GA
2994,Forsyth County-Dawson County-GA-1819,"Dawson County, GA",1819,2018,2019,491,14495000,912,30356000,-421,-15861000,Forsyth County,Forsyth County-Dawson County-GA
2995,Forsyth County-Lumpkin County-GA-1819,"Lumpkin County, GA",1819,2018,2019,180,4600000,309,11468000,-129,-6868000,Forsyth County,Forsyth County-Lumpkin County-GA
2996,Forsyth County-Los Angeles County-CA-1819,"Los Angeles County, CA",1819,2018,2019,115,5323000,54,2247000,61,3076000,Forsyth County,Forsyth County-Los Angeles County-CA
2997,Forsyth County-Cook County-IL-1819,"Cook County, IL",1819,2018,2019,88,4995000,64,2411000,24,2584000,Forsyth County,Forsyth County-Cook County-IL
2998,Forsyth County-Maricopa County-AZ-1819,"Maricopa County, AZ",1819,2018,2019,93,4184000,97,5363000,-4,-1179000,Forsyth County,Forsyth County-Maricopa County-AZ
2999,Forsyth County-Henry County-GA-1819,"Henry County, GA",1819,2018,2019,97,3238000,47,1886000,50,1352000,Forsyth County,Forsyth County-Henry County-GA
3000,Forsyth County-Orange County-FL-1819,"Orange County, FL",1819,2018,2019,80,3019000,51,2331000,29,688000,Forsyth County,Forsyth County-Orange County-FL
3001,Forsyth County-Barrow County-GA-1819,"Barrow County, GA",1819,2018,2019,71,1747000,66,2543000,5,-796000,Forsyth County,Forsyth County-Barrow County-GA
3002,Forsyth County-Clarke County-GA-1819,"Clarke County, GA",1819,2018,2019,48,1548000,33,1289000,15,259000,Forsyth County,Forsyth County-Clarke County-GA
3003,Forsyth County-Mecklenburg County-NC-1819,"Mecklenburg County, NC",1819,2018,2019,82,3402000,85,3985000,-3,-583000,Forsyth County,Forsyth County-Mecklenburg County-NC
3004,Forsyth County-Palm Beach County-FL-1819,"Palm Beach County, FL",1819,2018,2019,73,3175000,39,2587000,34,588000,Forsyth County,Forsyth County-Palm Beach County-FL
3005,Forsyth County-Pickens County-GA-1819,"Pickens County, GA",1819,2018,2019,73,1842000,100,5310000,-27,-3468000,Forsyth County,Forsyth County-Pickens County-GA
3006,Forsyth County-Paulding County-GA-1819,"Paulding County, GA",1819,2018,2019,68,2317000,65,1668000,3,649000,Forsyth County,Forsyth County-Paulding County-GA
3007,Forsyth County-Dallas County-TX-1819,"Dallas County, TX",1819,2018,2019,67,4058000,42,1782000,25,2276000,Forsyth County,Forsyth County-Dallas County-TX
3008,Forsyth County-Duval County-FL-1819,"Duval County, FL",1819,2018,2019,50,1241000,63,2637000,-13,-1396000,Forsyth County,Forsyth County-Duval County-FL
3009,Forsyth County-Hillsborough County-FL-1819,"Hillsborough County, FL",1819,2018,2019,63,2700000,66,4167000,-3,-1467000,Forsyth County,Forsyth County-Hillsborough County-FL
3010,Forsyth County-Wake County-NC-1819,"Wake County, NC",1819,2018,2019,68,3124000,40,2241000,28,883000,Forsyth County,Forsyth County-Wake County-NC
3011,Forsyth County-Jackson County-GA-1819,"Jackson County, GA",1819,2018,2019,61,2090000,70,2920000,-9,-830000,Forsyth County,Forsyth County-Jackson County-GA
3012,Forsyth County-White County-GA-1819,"White County, GA",1819,2018,2019,38,1040000,70,2937000,-32,-1897000,Forsyth County,Forsyth County-White County-GA
3013,Forsyth County-Greenville County-SC-1819,"Greenville County, SC",1819,2018,2019,42,1187000,48,2193000,-6,-1006000,Forsyth County,Forsyth County-Greenville County-SC
3014,Forsyth County-Collin County-TX-1819,"Collin County, TX",1819,2018,2019,54,2310000,70,4254000,-16,-1944000,Forsyth County,Forsyth County-Collin County-TX
3015,Forsyth County-Chatham County-GA-1819,"Chatham County, GA",1819,2018,2019,39,1043000,34,1379000,5,-336000,Forsyth County,Forsyth County-Chatham County-GA
3017,Fulton County-DeKalb County-GA-1819,"DeKalb County, GA",1819,2018,2019,13371,593000000,13787,612146000,-416,-19146000,Fulton County,Fulton County-DeKalb County-GA
3018,Fulton County-Cobb County-GA-1819,"Cobb County, GA",1819,2018,2019,8387,440190000,8999,420128000,-612,20062000,Fulton County,Fulton County-Cobb County-GA
3019,Fulton County-Gwinnett County-GA-1819,"Gwinnett County, GA",1819,2018,2019,5913,237095000,5520,183831000,393,53264000,Fulton County,Fulton County-Gwinnett County-GA
3020,Fulton County-Clayton County-GA-1819,"Clayton County, GA",1819,2018,2019,6334,84486000,7321,88978000,-987,-4492000,Fulton County,Fulton County-Clayton County-GA
3021,Fulton County-Forsyth County-GA-1819,"Forsyth County, GA",1819,2018,2019,2355,157137000,4753,223450000,-2398,-66313000,Fulton County,Fulton County-Forsyth County-GA
3022,Fulton County-Douglas County-GA-1819,"Douglas County, GA",1819,2018,2019,1491,32988000,1763,34342000,-272,-1354000,Fulton County,Fulton County-Douglas County-GA
3023,Fulton County-Cherokee County-GA-1819,"Cherokee County, GA",1819,2018,2019,1163,57443000,2441,127181000,-1278,-69738000,Fulton County,Fulton County-Cherokee County-GA
3024,Fulton County-Henry County-GA-1819,"Henry County, GA",1819,2018,2019,1185,33794000,1538,34248000,-353,-454000,Fulton County,Fulton County-Henry County-GA
3025,Fulton County-Fayette County-GA-1819,"Fayette County, GA",1819,2018,2019,958,39323000,1180,41246000,-222,-1923000,Fulton County,Fulton County-Fayette County-GA
3026,Fulton County-Cook County-IL-1819,"Cook County, IL",1819,2018,2019,925,60534000,574,36086000,351,24448000,Fulton County,Fulton County-Cook County-IL
3027,Fulton County-Los Angeles County-CA-1819,"Los Angeles County, CA",1819,2018,2019,784,49085000,689,38344000,95,10741000,Fulton County,Fulton County-Los Angeles County-CA
3028,Fulton County-Miami-Dade County-FL-1819,"Miami-Dade County, FL",1819,2018,2019,666,25797000,438,28977000,228,-3180000,Fulton County,Fulton County-Miami-Dade County-FL
3029,Fulton County-New York County-NY-1819,"New York County, NY",1819,2018,2019,536,59755000,474,43774000,62,15981000,Fulton County,Fulton County-New York County-NY
3030,Fulton County-Coweta County-GA-1819,"Coweta County, GA",1819,2018,2019,709,22015000,869,25325000,-160,-3310000,Fulton County,Fulton County-Coweta County-GA
3031,Fulton County-Broward County-FL-1819,"Broward County, FL",1819,2018,2019,627,24660000,404,30843000,223,-6183000,Fulton County,Fulton County-Broward County-FL
3032,Fulton County-Mecklenburg County-NC-1819,"Mecklenburg County, NC",1819,2018,2019,507,30304000,514,46039000,-7,-15735000,Fulton County,Fulton County-Mecklenburg County-NC
3033,Fulton County-Kings County-NY-1819,"Kings County, NY",1819,2018,2019,449,20119000,296,15157000,153,4962000,Fulton County,Fulton County-Kings County-NY
3034,Fulton County-Dallas County-TX-1819,"Dallas County, TX",1819,2018,2019,414,26357000,404,32434000,10,-6077000,Fulton County,Fulton County-Dallas County-TX
3035,Fulton County-Harris County-TX-1819,"Harris County, TX",1819,2018,2019,427,28212000,375,19729000,52,8483000,Fulton County,Fulton County-Harris County-TX
3036,Fulton County-Clarke County-GA-1819,"Clarke County, GA",1819,2018,2019,349,11745000,241,10473000,108,1272000,Fulton County,Fulton County-Clarke County-GA
3037,Fulton County-Hillsborough County-FL-1819,"Hillsborough County, FL",1819,2018,2019,404,20653000,391,21465000,13,-812000,Fulton County,Fulton County-Hillsborough County-FL
3038,Fulton County-Orange County-FL-1819,"Orange County, FL",1819,2018,2019,361,15241000,325,22725000,36,-7484000,Fulton County,Fulton County-Orange County-FL
3039,Fulton County-Chatham County-GA-1819,"Chatham County, GA",1819,2018,2019,355,11775000,240,11107000,115,668000,Fulton County,Fulton County-Chatham County-GA
3040,Fulton County-Paulding County-GA-1819,"Paulding County, GA",1819,2018,2019,399,11772000,566,13011000,-167,-1239000,Fulton County,Fulton County-Paulding County-GA
3041,Fulton County-Davidson County-TN-1819,"Davidson County, TN",1819,2018,2019,318,25332000,310,19290000,8,6042000,Fulton County,Fulton County-Davidson County-TN
3042,Fulton County-Jefferson County-AL-1819,"Jefferson County, AL",1819,2018,2019,334,23571000,245,14241000,89,9330000,Fulton County,Fulton County-Jefferson County-AL
3043,Fulton County-Palm Beach County-FL-1819,"Palm Beach County, FL",1819,2018,2019,371,18651000,343,48343000,28,-29692000,Fulton County,Fulton County-Palm Beach County-FL
3044,Fulton County-Hall County-GA-1819,"Hall County, GA",1819,2018,2019,339,19364000,401,24176000,-62,-4812000,Fulton County,Fulton County-Hall County-GA
3045,Fulton County-District of Columbia-DC-1819,"District of Columbia, DC",1819,2018,2019,274,19915000,272,20269000,2,-354000,Fulton County,Fulton County-District of Columbia-DC
3046,Fulton County-Rockdale County-GA-1819,"Rockdale County, GA",1819,2018,2019,384,9694000,348,7323000,36,2371000,Fulton County,Fulton County-Rockdale County-GA
3047,Fulton County-Duval County-FL-1819,"Duval County, FL",1819,2018,2019,326,13295000,271,13500000,55,-205000,Fulton County,Fulton County-Duval County-FL
3048,Fulton County-Maricopa County-AZ-1819,"Maricopa County, AZ",1819,2018,2019,325,18303000,372,29492000,-47,-11189000,Fulton County,Fulton County-Maricopa County-AZ
3049,Fulton County-Wake County-NC-1819,"Wake County, NC",1819,2018,2019,272,12540000,289,14771000,-17,-2231000,Fulton County,Fulton County-Wake County-NC
3050,Fulton County-King County-WA-1819,"King County, WA",1819,2018,2019,309,18149000,448,32643000,-139,-14494000,Fulton County,Fulton County-King County-WA
3051,Fulton County-Queens County-NY-1819,"Queens County, NY",1819,2018,2019,257,12425000,129,4880000,128,7545000,Fulton County,Fulton County-Queens County-NY
3052,Fulton County-Shelby County-TN-1819,"Shelby County, TN",1819,2018,2019,275,9862000,218,11374000,57,-1512000,Fulton County,Fulton County-Shelby County-TN
3053,Fulton County-Muscogee County-GA-1819,"Muscogee County, GA",1819,2018,2019,269,8854000,172,5318000,97,3536000,Fulton County,Fulton County-Muscogee County-GA
3054,Fulton County-San Diego County-CA-1819,"San Diego County, CA",1819,2018,2019,250,12304000,206,11586000,44,718000,Fulton County,Fulton County-San Diego County-CA
3055,Fulton County-Newton County-GA-1819,"Newton County, GA",1819,2018,2019,255,7098000,319,7246000,-64,-148000,Fulton County,Fulton County-Newton County-GA
3056,Fulton County-Philadelphia County-PA-1819,"Philadelphia County, PA",1819,2018,2019,207,10818000,167,9409000,40,1409000,Fulton County,Fulton County-Philadelphia County-PA
3057,Fulton County-Alameda County-CA-1819,"Alameda County, CA",1819,2018,2019,231,25020000,171,9433000,60,15587000,Fulton County,Fulton County-Alameda County-CA
3058,Fulton County-San Francisco County-CA-1819,"San Francisco County, CA",1819,2018,2019,173,20773000,198,21420000,-25,-647000,Fulton County,Fulton County-San Francisco County-CA
3059,Fulton County-Fairfax County-VA-1819,"Fairfax County, VA",1819,2018,2019,212,14828000,214,14142000,-2,686000,Fulton County,Fulton County-Fairfax County-VA
3060,Fulton County-Oakland County-MI-1819,"Oakland County, MI",1819,2018,2019,248,12452000,102,7452000,146,5000000,Fulton County,Fulton County-Oakland County-MI
3061,Fulton County-Prince George's County-MD-1819,"Prince George's County, MD",1819,2018,2019,172,6156000,132,4928000,40,1228000,Fulton County,Fulton County-Prince George's County-MD
3062,Fulton County-Richmond County-GA-1819,"Richmond County, GA",1819,2018,2019,206,5624000,123,4720000,83,904000,Fulton County,Fulton County-Richmond County-GA
3063,Fulton County-Collin County-TX-1819,"Collin County, TX",1819,2018,2019,238,14452000,274,11982000,-36,2470000,Fulton County,Fulton County-Collin County-TX
3064,Fulton County-Bibb County-GA-1819,"Bibb County, GA",1819,2018,2019,218,9104000,189,6256000,29,2848000,Fulton County,Fulton County-Bibb County-GA
3065,Fulton County-Suffolk County-MA-1819,"Suffolk County, MA",1819,2018,2019,158,11181000,145,9956000,13,1225000,Fulton County,Fulton County-Suffolk County-MA
3066,Fulton County-Pinellas County-FL-1819,"Pinellas County, FL",1819,2018,2019,195,11346000,213,25926000,-18,-14580000,Fulton County,Fulton County-Pinellas County-FL
3067,Fulton County-Richland County-SC-1819,"Richland County, SC",1819,2018,2019,181,6473000,108,2988000,73,3485000,Fulton County,Fulton County-Richland County-SC
3068,Fulton County-Franklin County-OH-1819,"Franklin County, OH",1819,2018,2019,178,8580000,132,6955000,46,1625000,Fulton County,Fulton County-Franklin County-OH
3069,Fulton County-Cuyahoga County-OH-1819,"Cuyahoga County, OH",1819,2018,2019,189,15297000,116,4209000,73,11088000,Fulton County,Fulton County-Cuyahoga County-OH
3070,Fulton County-Charleston County-SC-1819,"Charleston County, SC",1819,2018,2019,166,6752000,200,25585000,-34,-18833000,Fulton County,Fulton County-Charleston County-SC
3071,Fulton County-Orange County-CA-1819,"Orange County, CA",1819,2018,2019,202,13137000,221,17508000,-19,-4371000,Fulton County,Fulton County-Orange County-CA
3072,Fulton County-Travis County-TX-1819,"Travis County, TX",1819,2018,2019,161,18493000,292,22915000,-131,-4422000,Fulton County,Fulton County-Travis County-TX
3073,Fulton County-Hennepin County-MN-1819,"Hennepin County, MN",1819,2018,2019,219,16130000,95,4861000,124,11269000,Fulton County,Fulton County-Hennepin County-MN
3074,Fulton County-Denver County-CO-1819,"Denver County, CO",1819,2018,2019,134,8408000,253,33918000,-119,-25510000,Fulton County,Fulton County-Denver County-CO
3075,Fulton County-Santa Clara County-CA-1819,"Santa Clara County, CA",1819,2018,2019,194,20834000,326,24945000,-132,-4111000,Fulton County,Fulton County-Santa Clara County-CA
3076,Fulton County-Middlesex County-MA-1819,"Middlesex County, MA",1819,2018,2019,175,14599000,159,12060000,16,2539000,Fulton County,Fulton County-Middlesex County-MA
3077,Fulton County-Leon County-FL-1819,"Leon County, FL",1819,2018,2019,151,5139000,103,5376000,48,-237000,Fulton County,Fulton County-Leon County-FL
3078,Fulton County-Allegheny County-PA-1819,"Allegheny County, PA",1819,2018,2019,164,8710000,129,6012000,35,2698000,Fulton County,Fulton County-Allegheny County-PA
3079,Fulton County-Greenville County-SC-1819,"Greenville County, SC",1819,2018,2019,168,7618000,158,7314000,10,304000,Fulton County,Fulton County-Greenville County-SC
3080,Fulton County-Carroll County-GA-1819,"Carroll County, GA",1819,2018,2019,180,5084000,191,4621000,-11,463000,Fulton County,Fulton County-Carroll County-GA
3081,Fulton County-Middlesex County-NJ-1819,"Middlesex County, NJ",1819,2018,2019,182,8158000,107,4054000,75,4104000,Fulton County,Fulton County-Middlesex County-NJ
3082,Fulton County-Montgomery County-AL-1819,"Montgomery County, AL",1819,2018,2019,161,11127000,85,3256000,76,7871000,Fulton County,Fulton County-Montgomery County-AL
3083,Fulton County-Marion County-IN-1819,"Marion County, IN",1819,2018,2019,166,5842000,69,2332000,97,3510000,Fulton County,Fulton County-Marion County-IN
3084,Fulton County-Clark County-NV-1819,"Clark County, NV",1819,2018,2019,165,7283000,191,10666000,-26,-3383000,Fulton County,Fulton County-Clark County-NV
3085,Fulton County-Nassau County-NY-1819,"Nassau County, NY",1819,2018,2019,182,8953000,56,2248000,126,6705000,Fulton County,Fulton County-Nassau County-NY
3086,Fulton County-Montgomery County-MD-1819,"Montgomery County, MD",1819,2018,2019,150,13579000,141,11766000,9,1813000,Fulton County,Fulton County-Montgomery County-MD
3087,Fulton County-Hudson County-NJ-1819,"Hudson County, NJ",1819,2018,2019,166,11128000,130,9232000,36,1896000,Fulton County,Fulton County-Hudson County-NJ
3088,Fulton County-Tarrant County-TX-1819,"Tarrant County, TX",1819,2018,2019,174,8412000,166,12246000,8,-3834000,Fulton County,Fulton County-Tarrant County-TX
3089,Fulton County-Wayne County-MI-1819,"Wayne County, MI",1819,2018,2019,148,4825000,150,5021000,-2,-196000,Fulton County,Fulton County-Wayne County-MI
3090,Fulton County-Knox County-TN-1819,"Knox County, TN",1819,2018,2019,132,6441000,118,6451000,14,-10000,Fulton County,Fulton County-Knox County-TN
3091,Fulton County-Orleans Parish-LA-1819,"Orleans Parish, LA",1819,2018,2019,155,4176000,113,4367000,42,-191000,Fulton County,Fulton County-Orleans Parish-LA
3092,Fulton County-St. Louis County-MO-1819,"St. Louis County, MO",1819,2018,2019,160,9801000,87,4783000,73,5018000,Fulton County,Fulton County-St. Louis County-MO
3093,Fulton County-Alachua County-FL-1819,"Alachua County, FL",1819,2018,2019,118,4400000,69,3059000,49,1341000,Fulton County,Fulton County-Alachua County-FL
3094,Fulton County-Bronx County-NY-1819,"Bronx County, NY",1819,2018,2019,146,3047000,74,873000,72,2174000,Fulton County,Fulton County-Bronx County-NY
3095,Fulton County-Seminole County-FL-1819,"Seminole County, FL",1819,2018,2019,141,6217000,103,4227000,38,1990000,Fulton County,Fulton County-Seminole County-FL
3096,Fulton County-Essex County-NJ-1819,"Essex County, NJ",1819,2018,2019,155,7930000,70,2063000,85,5867000,Fulton County,Fulton County-Essex County-NJ
3097,Fulton County-Jefferson County-KY-1819,"Jefferson County, KY",1819,2018,2019,145,7996000,111,4815000,34,3181000,Fulton County,Fulton County-Jefferson County-KY
3098,Fulton County-Contra Costa County-CA-1819,"Contra Costa County, CA",1819,2018,2019,186,12139000,68,3632000,118,8507000,Fulton County,Fulton County-Contra Costa County-CA
3099,Fulton County-Houston County-GA-1819,"Houston County, GA",1819,2018,2019,136,4021000,92,2941000,44,1080000,Fulton County,Fulton County-Houston County-GA
3100,Fulton County-Bergen County-NJ-1819,"Bergen County, NJ",1819,2018,2019,139,11798000,54,3125000,85,8673000,Fulton County,Fulton County-Bergen County-NJ
3101,Fulton County-Hamilton County-TN-1819,"Hamilton County, TN",1819,2018,2019,138,7337000,154,9307000,-16,-1970000,Fulton County,Fulton County-Hamilton County-TN
3102,Fulton County-Columbia County-GA-1819,"Columbia County, GA",1819,2018,2019,129,5698000,63,2346000,66,3352000,Fulton County,Fulton County-Columbia County-GA
3103,Fulton County-Hamilton County-OH-1819,"Hamilton County, OH",1819,2018,2019,126,10098000,99,3944000,27,6154000,Fulton County,Fulton County-Hamilton County-OH
3104,Fulton County-Lee County-AL-1819,"Lee County, AL",1819,2018,2019,114,3324000,65,5114000,49,-1790000,Fulton County,Fulton County-Lee County-AL
3105,Fulton County-DuPage County-IL-1819,"DuPage County, IL",1819,2018,2019,146,10317000,68,4980000,78,5337000,Fulton County,Fulton County-DuPage County-IL
3106,Fulton County-Fairfield County-CT-1819,"Fairfield County, CT",1819,2018,2019,150,24808000,89,7431000,61,17377000,Fulton County,Fulton County-Fairfield County-CT
3107,Fulton County-Spalding County-GA-1819,"Spalding County, GA",1819,2018,2019,138,2224000,190,3214000,-52,-990000,Fulton County,Fulton County-Spalding County-GA
3108,Fulton County-Madison County-AL-1819,"Madison County, AL",1819,2018,2019,113,3344000,99,4441000,14,-1097000,Fulton County,Fulton County-Madison County-AL
3109,Fulton County-Walton County-GA-1819,"Walton County, GA",1819,2018,2019,124,3510000,122,2923000,2,587000,Fulton County,Fulton County-Walton County-GA
3110,Fulton County-Baltimore city-MD-1819,"Baltimore city, MD",1819,2018,2019,113,5886000,74,3625000,39,2261000,Fulton County,Fulton County-Baltimore city-MD
3111,Fulton County-Durham County-NC-1819,"Durham County, NC",1819,2018,2019,104,4684000,123,7699000,-19,-3015000,Fulton County,Fulton County-Durham County-NC
3112,Fulton County-Troup County-GA-1819,"Troup County, GA",1819,2018,2019,117,5420000,102,2901000,15,2519000,Fulton County,Fulton County-Troup County-GA
3113,Fulton County-Lee County-FL-1819,"Lee County, FL",1819,2018,2019,107,4877000,87,8859000,20,-3982000,Fulton County,Fulton County-Lee County-FL
3114,Fulton County-Dougherty County-GA-1819,"Dougherty County, GA",1819,2018,2019,124,2732000,60,1328000,64,1404000,Fulton County,Fulton County-Dougherty County-GA
3115,Fulton County-Mobile County-AL-1819,"Mobile County, AL",1819,2018,2019,119,2749000,89,1731000,30,1018000,Fulton County,Fulton County-Mobile County-AL
3116,Fulton County-Bexar County-TX-1819,"Bexar County, TX",1819,2018,2019,114,6055000,96,5307000,18,748000,Fulton County,Fulton County-Bexar County-TX
3117,Fulton County-Guilford County-NC-1819,"Guilford County, NC",1819,2018,2019,92,3732000,65,3358000,27,374000,Fulton County,Fulton County-Guilford County-NC
3118,Fulton County-Suffolk County-NY-1819,"Suffolk County, NY",1819,2018,2019,90,5603000,39,1240000,51,4363000,Fulton County,Fulton County-Suffolk County-NY
3119,Fulton County-Bartow County-GA-1819,"Bartow County, GA",1819,2018,2019,107,2486000,126,4450000,-19,-1964000,Fulton County,Fulton County-Bartow County-GA
3120,Fulton County-Westchester County-NY-1819,"Westchester County, NY",1819,2018,2019,116,7739000,46,1928000,70,5811000,Fulton County,Fulton County-Westchester County-NY
3121,Fulton County-Milwaukee County-WI-1819,"Milwaukee County, WI",1819,2018,2019,118,5153000,63,3040000,55,2113000,Fulton County,Fulton County-Milwaukee County-WI
3122,Fulton County-Multnomah County-OR-1819,"Multnomah County, OR",1819,2018,2019,82,4094000,75,4070000,7,24000,Fulton County,Fulton County-Multnomah County-OR
3123,Fulton County-Baltimore County-MD-1819,"Baltimore County, MD",1819,2018,2019,103,9120000,60,2819000,43,6301000,Fulton County,Fulton County-Baltimore County-MD
3124,Fulton County-Henrico County-VA-1819,"Henrico County, VA",1819,2018,2019,116,6188000,88,3046000,28,3142000,Fulton County,Fulton County-Henrico County-VA
3125,Fulton County-Hartford County-CT-1819,"Hartford County, CT",1819,2018,2019,105,9816000,76,3208000,29,6608000,Fulton County,Fulton County-Hartford County-CT
3126,Fulton County-Forsyth County-NC-1819,"Forsyth County, NC",1819,2018,2019,83,4310000,33,1596000,50,2714000,Fulton County,Fulton County-Forsyth County-NC
3127,Fulton County-Arlington County-VA-1819,"Arlington County, VA",1819,2018,2019,71,6931000,55,4251000,16,2680000,Fulton County,Fulton County-Arlington County-VA
3128,Fulton County-San Mateo County-CA-1819,"San Mateo County, CA",1819,2018,2019,94,10309000,75,4556000,19,5753000,Fulton County,Fulton County-San Mateo County-CA
3129,Fulton County-Volusia County-FL-1819,"Volusia County, FL",1819,2018,2019,82,2987000,91,3905000,-9,-918000,Fulton County,Fulton County-Volusia County-FL
3130,Fulton County-Buncombe County-NC-1819,"Buncombe County, NC",1819,2018,2019,72,3269000,69,5207000,3,-1938000,Fulton County,Fulton County-Buncombe County-NC
3131,Fulton County-Collier County-FL-1819,"Collier County, FL",1819,2018,2019,80,4623000,77,21618000,3,-16995000,Fulton County,Fulton County-Collier County-FL
3132,Fulton County-Sarasota County-FL-1819,"Sarasota County, FL",1819,2018,2019,80,4836000,88,12828000,-8,-7992000,Fulton County,Fulton County-Sarasota County-FL
3133,Fulton County-Virginia Beach city-VA-1819,"Virginia Beach city, VA",1819,2018,2019,96,8995000,61,3401000,35,5594000,Fulton County,Fulton County-Virginia Beach city-VA
3134,Fulton County-Polk County-FL-1819,"Polk County, FL",1819,2018,2019,89,2811000,71,2348000,18,463000,Fulton County,Fulton County-Polk County-FL
3135,Fulton County-Barrow County-GA-1819,"Barrow County, GA",1819,2018,2019,93,2888000,121,2973000,-28,-85000,Fulton County,Fulton County-Barrow County-GA
3136,Fulton County-East Baton Rouge Parish-LA-1819,"East Baton Rouge Parish, LA",1819,2018,2019,81,2736000,62,2101000,19,635000,Fulton County,Fulton County-East Baton Rouge Parish-LA
3137,Fulton County-Dane County-WI-1819,"Dane County, WI",1819,2018,2019,65,3182000,46,2225000,19,957000,Fulton County,Fulton County-Dane County-WI
3138,Fulton County-Brevard County-FL-1819,"Brevard County, FL",1819,2018,2019,78,3689000,84,6449000,-6,-2760000,Fulton County,Fulton County-Brevard County-FL
3139,Fulton County-Escambia County-FL-1819,"Escambia County, FL",1819,2018,2019,69,6067000,73,7901000,-4,-1834000,Fulton County,Fulton County-Escambia County-FL
3140,Fulton County-Floyd County-GA-1819,"Floyd County, GA",1819,2018,2019,82,2863000,89,2599000,-7,264000,Fulton County,Fulton County-Floyd County-GA
3141,Fulton County-Lowndes County-GA-1819,"Lowndes County, GA",1819,2018,2019,70,2575000,38,1127000,32,1448000,Fulton County,Fulton County-Lowndes County-GA
3142,Fulton County-Lexington County-SC-1819,"Lexington County, SC",1819,2018,2019,82,2602000,45,2278000,37,324000,Fulton County,Fulton County-Lexington County-SC
3143,Fulton County-Shelby County-AL-1819,"Shelby County, AL",1819,2018,2019,73,3966000,57,3076000,16,890000,Fulton County,Fulton County-Shelby County-AL
3144,Fulton County-St. Louis city-MO-1819,"St. Louis city, MO",1819,2018,2019,67,2631000,40,1825000,27,806000,Fulton County,Fulton County-St. Louis city-MO
3145,Fulton County-Fort Bend County-TX-1819,"Fort Bend County, TX",1819,2018,2019,83,7194000,61,1660000,22,5534000,Fulton County,Fulton County-Fort Bend County-TX
3146,Fulton County-New Castle County-DE-1819,"New Castle County, DE",1819,2018,2019,85,3150000,61,2074000,24,1076000,Fulton County,Fulton County-New Castle County-DE
3147,Fulton County-Oconee County-GA-1819,"Oconee County, GA",1819,2018,2019,69,3850000,56,3145000,13,705000,Fulton County,Fulton County-Oconee County-GA
3148,Fulton County-Montgomery County-PA-1819,"Montgomery County, PA",1819,2018,2019,84,4523000,67,3590000,17,933000,Fulton County,Fulton County-Montgomery County-PA
3149,Fulton County-Richmond city-VA-1819,"Richmond city, VA",1819,2018,2019,70,3569000,45,2299000,25,1270000,Fulton County,Fulton County-Richmond city-VA
3150,Fulton County-Pulaski County-AR-1819,"Pulaski County, AR",1819,2018,2019,86,2245000,38,1467000,48,778000,Fulton County,Fulton County-Pulaski County-AR
3151,Fulton County-Arapahoe County-CO-1819,"Arapahoe County, CO",1819,2018,2019,81,5042000,92,3993000,-11,1049000,Fulton County,Fulton County-Arapahoe County-CO
3152,Fulton County-New Haven County-CT-1819,"New Haven County, CT",1819,2018,2019,95,3366000,49,1863000,46,1503000,Fulton County,Fulton County-New Haven County-CT
3153,Fulton County-Williamson County-TN-1819,"Williamson County, TN",1819,2018,2019,84,7003000,102,5403000,-18,1600000,Fulton County,Fulton County-Williamson County-TN
3154,Fulton County-Bay County-FL-1819,"Bay County, FL",1819,2018,2019,84,4854000,49,2640000,35,2214000,Fulton County,Fulton County-Bay County-FL
3155,Fulton County-Rutherford County-TN-1819,"Rutherford County, TN",1819,2018,2019,72,2467000,54,2618000,18,-151000,Fulton County,Fulton County-Rutherford County-TN
3156,Fulton County-Sacramento County-CA-1819,"Sacramento County, CA",1819,2018,2019,82,2568000,67,2797000,15,-229000,Fulton County,Fulton County-Sacramento County-CA
3157,Fulton County-St. Johns County-FL-1819,"St. Johns County, FL",1819,2018,2019,75,4448000,163,25599000,-88,-21151000,Fulton County,Fulton County-St. Johns County-FL
3158,Fulton County-Dawson County-GA-1819,"Dawson County, GA",1819,2018,2019,66,2787000,124,7397000,-58,-4610000,Fulton County,Fulton County-Dawson County-GA
3159,Fulton County-Johnson County-KS-1819,"Johnson County, KS",1819,2018,2019,87,10633000,55,4482000,32,6151000,Fulton County,Fulton County-Johnson County-KS
3160,Fulton County-Denton County-TX-1819,"Denton County, TX",1819,2018,2019,81,4845000,142,10584000,-61,-5739000,Fulton County,Fulton County-Denton County-TX
3161,Fulton County-Pasco County-FL-1819,"Pasco County, FL",1819,2018,2019,93,4950000,71,2457000,22,2493000,Fulton County,Fulton County-Pasco County-FL
3162,Fulton County-Glynn County-GA-1819,"Glynn County, GA",1819,2018,2019,64,2358000,125,16229000,-61,-13871000,Fulton County,Fulton County-Glynn County-GA
3163,Fulton County-Beaufort County-SC-1819,"Beaufort County, SC",1819,2018,2019,57,3441000,152,19720000,-95,-16279000,Fulton County,Fulton County-Beaufort County-SC
3164,Fulton County-Riverside County-CA-1819,"Riverside County, CA",1819,2018,2019,70,3845000,49,2282000,21,1563000,Fulton County,Fulton County-Riverside County-CA
3165,Fulton County-Washtenaw County-MI-1819,"Washtenaw County, MI",1819,2018,2019,50,2904000,33,2096000,17,808000,Fulton County,Fulton County-Washtenaw County-MI
3166,Fulton County-Tuscaloosa County-AL-1819,"Tuscaloosa County, AL",1819,2018,2019,60,1937000,43,1930000,17,7000,Fulton County,Fulton County-Tuscaloosa County-AL
3167,Fulton County-Douglas County-CO-1819,"Douglas County, CO",1819,2018,2019,74,4056000,50,2565000,24,1491000,Fulton County,Fulton County-Douglas County-CO
3168,Fulton County-El Paso County-CO-1819,"El Paso County, CO",1819,2018,2019,80,2131000,55,1344000,25,787000,Fulton County,Fulton County-El Paso County-CO
3169,Fulton County-Bulloch County-GA-1819,"Bulloch County, GA",1819,2018,2019,55,1285000,45,1351000,10,-66000,Fulton County,Fulton County-Bulloch County-GA
3170,Fulton County-Jackson County-GA-1819,"Jackson County, GA",1819,2018,2019,69,2920000,76,3408000,-7,-488000,Fulton County,Fulton County-Jackson County-GA
3171,Fulton County-Norfolk County-MA-1819,"Norfolk County, MA",1819,2018,2019,67,2687000,73,4916000,-6,-2229000,Fulton County,Fulton County-Norfolk County-MA
3172,Fulton County-Cumberland County-NC-1819,"Cumberland County, NC",1819,2018,2019,75,1248000,54,1093000,21,155000,Fulton County,Fulton County-Cumberland County-NC
3173,Fulton County-Salt Lake County-UT-1819,"Salt Lake County, UT",1819,2018,2019,68,2311000,73,6462000,-5,-4151000,Fulton County,Fulton County-Salt Lake County-UT
3174,Fulton County-Alexandria city-VA-1819,"Alexandria city, VA",1819,2018,2019,63,7497000,69,3722000,-6,3775000,Fulton County,Fulton County-Alexandria city-VA
3175,Fulton County-Anne Arundel County-MD-1819,"Anne Arundel County, MD",1819,2018,2019,77,4074000,37,1784000,40,2290000,Fulton County,Fulton County-Anne Arundel County-MD
3176,Fulton County-Hinds County-MS-1819,"Hinds County, MS",1819,2018,2019,58,1383000,43,522000,15,861000,Fulton County,Fulton County-Hinds County-MS
3177,Fulton County-Bernalillo County-NM-1819,"Bernalillo County, NM",1819,2018,2019,59,2895000,38,2479000,21,416000,Fulton County,Fulton County-Bernalillo County-NM
3178,Fulton County-San Bernardino County-CA-1819,"San Bernardino County, CA",1819,2018,2019,56,1589000,60,1588000,-4,1000,Fulton County,Fulton County-San Bernardino County-CA
3179,Fulton County-Lumpkin County-GA-1819,"Lumpkin County, GA",1819,2018,2019,50,1812000,43,1975000,7,-163000,Fulton County,Fulton County-Lumpkin County-GA
3180,Fulton County-Manatee County-FL-1819,"Manatee County, FL",1819,2018,2019,62,3743000,108,12345000,-46,-8602000,Fulton County,Fulton County-Manatee County-FL
3181,Fulton County-Union County-NJ-1819,"Union County, NJ",1819,2018,2019,58,3741000,37,1311000,21,2430000,Fulton County,Fulton County-Union County-NJ
3182,Fulton County-Jackson County-MO-1819,"Jackson County, MO",1819,2018,2019,62,2269000,37,1970000,25,299000,Fulton County,Fulton County-Jackson County-MO
3183,Fulton County-Montgomery County-OH-1819,"Montgomery County, OH",1819,2018,2019,65,2019000,51,1259000,14,760000,Fulton County,Fulton County-Montgomery County-OH
3184,Fulton County-Chester County-PA-1819,"Chester County, PA",1819,2018,2019,78,5031000,27,1325000,51,3706000,Fulton County,Fulton County-Chester County-PA
3185,Fulton County-Oklahoma County-OK-1819,"Oklahoma County, OK",1819,2018,2019,76,3066000,36,1182000,40,1884000,Fulton County,Fulton County-Oklahoma County-OK
3186,Fulton County-Okaloosa County-FL-1819,"Okaloosa County, FL",1819,2018,2019,57,1859000,55,3269000,2,-1410000,Fulton County,Fulton County-Okaloosa County-FL
3187,Fulton County-Honolulu County-HI-1819,"Honolulu County, HI",1819,2018,2019,55,2097000,57,3894000,-2,-1797000,Fulton County,Fulton County-Honolulu County-HI
3188,Fulton County-Jefferson Parish-LA-1819,"Jefferson Parish, LA",1819,2018,2019,62,1263000,59,2393000,3,-1130000,Fulton County,Fulton County-Jefferson Parish-LA
3189,Fulton County-Baldwin County-AL-1819,"Baldwin County, AL",1819,2018,2019,53,5674000,55,2966000,-2,2708000,Fulton County,Fulton County-Baldwin County-AL
3190,Fulton County-Providence County-RI-1819,"Providence County, RI",1819,2018,2019,42,1628000,46,1407000,-4,221000,Fulton County,Fulton County-Providence County-RI
3191,Fulton County-Loudoun County-VA-1819,"Loudoun County, VA",1819,2018,2019,58,3802000,61,3111000,-3,691000,Fulton County,Fulton County-Loudoun County-VA
3192,Fulton County-Habersham County-GA-1819,"Habersham County, GA",1819,2018,2019,44,1908000,39,1653000,5,255000,Fulton County,Fulton County-Habersham County-GA
3193,Fulton County-Macomb County-MI-1819,"Macomb County, MI",1819,2018,2019,48,1161000,38,1619000,10,-458000,Fulton County,Fulton County-Macomb County-MI
3194,Fulton County-Pima County-AZ-1819,"Pima County, AZ",1819,2018,2019,39,2165000,44,2011000,-5,154000,Fulton County,Fulton County-Pima County-AZ
3195,Fulton County-Walton County-FL-1819,"Walton County, FL",1819,2018,2019,35,5719000,94,41011000,-59,-35292000,Fulton County,Fulton County-Walton County-FL
3196,Fulton County-Spartanburg County-SC-1819,"Spartanburg County, SC",1819,2018,2019,33,1818000,33,1326000,0,492000,Fulton County,Fulton County-Spartanburg County-SC
3197,Fulton County-Williamson County-TX-1819,"Williamson County, TX",1819,2018,2019,36,1592000,49,2510000,-13,-918000,Fulton County,Fulton County-Williamson County-TX
3198,Fulton County-Pierce County-WA-1819,"Pierce County, WA",1819,2018,2019,51,2208000,43,1568000,8,640000,Fulton County,Fulton County-Pierce County-WA
3199,Fulton County-St. Lucie County-FL-1819,"St. Lucie County, FL",1819,2018,2019,45,1189000,44,1417000,1,-228000,Fulton County,Fulton County-St. Lucie County-FL
3200,Fulton County-Hamilton County-IN-1819,"Hamilton County, IN",1819,2018,2019,59,3041000,40,3422000,19,-381000,Fulton County,Fulton County-Hamilton County-IN
3201,Fulton County-Montgomery County-TN-1819,"Montgomery County, TN",1819,2018,2019,35,596000,38,943000,-3,-347000,Fulton County,Fulton County-Montgomery County-TN
3202,Fulton County-Benton County-AR-1819,"Benton County, AR",1819,2018,2019,39,2623000,55,3903000,-16,-1280000,Fulton County,Fulton County-Benton County-AR
3203,Fulton County-Osceola County-FL-1819,"Osceola County, FL",1819,2018,2019,50,1104000,51,2253000,-1,-1149000,Fulton County,Fulton County-Osceola County-FL
3204,Fulton County-Pickens County-GA-1819,"Pickens County, GA",1819,2018,2019,29,951000,91,9119000,-62,-8168000,Fulton County,Fulton County-Pickens County-GA
3205,Fulton County-Whitfield County-GA-1819,"Whitfield County, GA",1819,2018,2019,35,1146000,35,1456000,0,-310000,Fulton County,Fulton County-Whitfield County-GA
3206,Fulton County-Howard County-MD-1819,"Howard County, MD",1819,2018,2019,39,3193000,51,2970000,-12,223000,Fulton County,Fulton County-Howard County-MD
3207,Fulton County-York County-SC-1819,"York County, SC",1819,2018,2019,31,918000,37,1874000,-6,-956000,Fulton County,Fulton County-York County-SC
3208,Fulton County-Bell County-TX-1819,"Bell County, TX",1819,2018,2019,49,1041000,53,793000,-4,248000,Fulton County,Fulton County-Bell County-TX
3209,Fulton County-Berkeley County-SC-1819,"Berkeley County, SC",1819,2018,2019,31,1631000,54,2239000,-23,-608000,Fulton County,Fulton County-Berkeley County-SC
3211,Gwinnett County-DeKalb County-GA-1819,"DeKalb County, GA",1819,2018,2019,11547,261314000,8059,202314000,3488,59000000,Gwinnett County,Gwinnett County-DeKalb County-GA
3212,Gwinnett County-Fulton County-GA-1819,"Fulton County, GA",1819,2018,2019,5520,183831000,5913,237095000,-393,-53264000,Gwinnett County,Gwinnett County-Fulton County-GA
3213,Gwinnett County-Cobb County-GA-1819,"Cobb County, GA",1819,2018,2019,2249,59776000,2088,59918000,161,-142000,Gwinnett County,Gwinnett County-Cobb County-GA
3214,Gwinnett County-Hall County-GA-1819,"Hall County, GA",1819,2018,2019,1685,46474000,2999,109271000,-1314,-62797000,Gwinnett County,Gwinnett County-Hall County-GA
3215,Gwinnett County-Forsyth County-GA-1819,"Forsyth County, GA",1819,2018,2019,1267,44778000,2440,93656000,-1173,-48878000,Gwinnett County,Gwinnett County-Forsyth County-GA
3216,Gwinnett County-Barrow County-GA-1819,"Barrow County, GA",1819,2018,2019,1192,25407000,2608,61084000,-1416,-35677000,Gwinnett County,Gwinnett County-Barrow County-GA
3217,Gwinnett County-Walton County-GA-1819,"Walton County, GA",1819,2018,2019,1060,27811000,2796,77914000,-1736,-50103000,Gwinnett County,Gwinnett County-Walton County-GA
3218,Gwinnett County-Clayton County-GA-1819,"Clayton County, GA",1819,2018,2019,913,14088000,821,11465000,92,2623000,Gwinnett County,Gwinnett County-Clayton County-GA
3219,Gwinnett County-Broward County-FL-1819,"Broward County, FL",1819,2018,2019,662,11852000,322,7597000,340,4255000,Gwinnett County,Gwinnett County-Broward County-FL
3220,Gwinnett County-Rockdale County-GA-1819,"Rockdale County, GA",1819,2018,2019,589,12460000,789,15507000,-200,-3047000,Gwinnett County,Gwinnett County-Rockdale County-GA
3221,Gwinnett County-Miami-Dade County-FL-1819,"Miami-Dade County, FL",1819,2018,2019,581,9822000,323,7470000,258,2352000,Gwinnett County,Gwinnett County-Miami-Dade County-FL
3222,Gwinnett County-Henry County-GA-1819,"Henry County, GA",1819,2018,2019,534,11823000,632,12259000,-98,-436000,Gwinnett County,Gwinnett County-Henry County-GA
3223,Gwinnett County-Newton County-GA-1819,"Newton County, GA",1819,2018,2019,516,11116000,668,14318000,-152,-3202000,Gwinnett County,Gwinnett County-Newton County-GA
3224,Gwinnett County-Los Angeles County-CA-1819,"Los Angeles County, CA",1819,2018,2019,480,11807000,308,8284000,172,3523000,Gwinnett County,Gwinnett County-Los Angeles County-CA
3225,Gwinnett County-Queens County-NY-1819,"Queens County, NY",1819,2018,2019,496,9855000,155,3570000,341,6285000,Gwinnett County,Gwinnett County-Queens County-NY
3226,Gwinnett County-Clarke County-GA-1819,"Clarke County, GA",1819,2018,2019,398,9047000,414,10681000,-16,-1634000,Gwinnett County,Gwinnett County-Clarke County-GA
3227,Gwinnett County-Cherokee County-GA-1819,"Cherokee County, GA",1819,2018,2019,426,12849000,653,25413000,-227,-12564000,Gwinnett County,Gwinnett County-Cherokee County-GA
3228,Gwinnett County-Jackson County-GA-1819,"Jackson County, GA",1819,2018,2019,465,21230000,1562,50911000,-1097,-29681000,Gwinnett County,Gwinnett County-Jackson County-GA
3229,Gwinnett County-Kings County-NY-1819,"Kings County, NY",1819,2018,2019,419,7735000,142,3060000,277,4675000,Gwinnett County,Gwinnett County-Kings County-NY
3230,Gwinnett County-Cook County-IL-1819,"Cook County, IL",1819,2018,2019,392,9708000,227,5503000,165,4205000,Gwinnett County,Gwinnett County-Cook County-IL
3231,Gwinnett County-Orange County-FL-1819,"Orange County, FL",1819,2018,2019,373,6595000,226,5927000,147,668000,Gwinnett County,Gwinnett County-Orange County-FL
3232,Gwinnett County-Harris County-TX-1819,"Harris County, TX",1819,2018,2019,348,7442000,276,8024000,72,-582000,Gwinnett County,Gwinnett County-Harris County-TX
3233,Gwinnett County-Douglas County-GA-1819,"Douglas County, GA",1819,2018,2019,328,6707000,276,5771000,52,936000,Gwinnett County,Gwinnett County-Douglas County-GA
3234,Gwinnett County-Hillsborough County-FL-1819,"Hillsborough County, FL",1819,2018,2019,297,6601000,282,6974000,15,-373000,Gwinnett County,Gwinnett County-Hillsborough County-FL
3235,Gwinnett County-Mecklenburg County-NC-1819,"Mecklenburg County, NC",1819,2018,2019,245,6696000,248,7757000,-3,-1061000,Gwinnett County,Gwinnett County-Mecklenburg County-NC
3236,Gwinnett County-Bronx County-NY-1819,"Bronx County, NY",1819,2018,2019,306,4986000,87,1296000,219,3690000,Gwinnett County,Gwinnett County-Bronx County-NY
3237,Gwinnett County-Palm Beach County-FL-1819,"Palm Beach County, FL",1819,2018,2019,248,6162000,194,8548000,54,-2386000,Gwinnett County,Gwinnett County-Palm Beach County-FL
3238,Gwinnett County-Chatham County-GA-1819,"Chatham County, GA",1819,2018,2019,226,4513000,158,4768000,68,-255000,Gwinnett County,Gwinnett County-Chatham County-GA
3239,Gwinnett County-Duval County-FL-1819,"Duval County, FL",1819,2018,2019,207,5138000,252,7598000,-45,-2460000,Gwinnett County,Gwinnett County-Duval County-FL
3240,Gwinnett County-Shelby County-TN-1819,"Shelby County, TN",1819,2018,2019,201,3500000,124,2542000,77,958000,Gwinnett County,Gwinnett County-Shelby County-TN
3241,Gwinnett County-Suffolk County-NY-1819,"Suffolk County, NY",1819,2018,2019,195,4725000,61,983000,134,3742000,Gwinnett County,Gwinnett County-Suffolk County-NY
3242,Gwinnett County-Jefferson County-AL-1819,"Jefferson County, AL",1819,2018,2019,190,4967000,153,3854000,37,1113000,Gwinnett County,Gwinnett County-Jefferson County-AL
3243,Gwinnett County-Orange County-CA-1819,"Orange County, CA",1819,2018,2019,225,4823000,150,6594000,75,-1771000,Gwinnett County,Gwinnett County-Orange County-CA
3244,Gwinnett County-Essex County-NJ-1819,"Essex County, NJ",1819,2018,2019,178,3593000,47,736000,131,2857000,Gwinnett County,Gwinnett County-Essex County-NJ
3245,Gwinnett County-Maricopa County-AZ-1819,"Maricopa County, AZ",1819,2018,2019,194,5586000,199,6358000,-5,-772000,Gwinnett County,Gwinnett County-Maricopa County-AZ
3246,Gwinnett County-Paulding County-GA-1819,"Paulding County, GA",1819,2018,2019,188,4195000,209,6250000,-21,-2055000,Gwinnett County,Gwinnett County-Paulding County-GA
3247,Gwinnett County-Nassau County-NY-1819,"Nassau County, NY",1819,2018,2019,164,4686000,59,1258000,105,3428000,Gwinnett County,Gwinnett County-Nassau County-NY
3248,Gwinnett County-Davidson County-TN-1819,"Davidson County, TN",1819,2018,2019,159,3956000,120,4045000,39,-89000,Gwinnett County,Gwinnett County-Davidson County-TN
3249,Gwinnett County-Muscogee County-GA-1819,"Muscogee County, GA",1819,2018,2019,157,3536000,117,2572000,40,964000,Gwinnett County,Gwinnett County-Muscogee County-GA
3250,Gwinnett County-Richmond County-GA-1819,"Richmond County, GA",1819,2018,2019,149,3498000,133,3013000,16,485000,Gwinnett County,Gwinnett County-Richmond County-GA
3251,Gwinnett County-Wake County-NC-1819,"Wake County, NC",1819,2018,2019,171,5453000,139,5754000,32,-301000,Gwinnett County,Gwinnett County-Wake County-NC
3252,Gwinnett County-San Diego County-CA-1819,"San Diego County, CA",1819,2018,2019,148,4539000,154,3858000,-6,681000,Gwinnett County,Gwinnett County-San Diego County-CA
3253,Gwinnett County-Fayette County-GA-1819,"Fayette County, GA",1819,2018,2019,134,3369000,187,6406000,-53,-3037000,Gwinnett County,Gwinnett County-Fayette County-GA
3254,Gwinnett County-New York County-NY-1819,"New York County, NY",1819,2018,2019,133,2979000,99,5495000,34,-2516000,Gwinnett County,Gwinnett County-New York County-NY
3255,Gwinnett County-Dallas County-TX-1819,"Dallas County, TX",1819,2018,2019,127,3343000,150,7466000,-23,-4123000,Gwinnett County,Gwinnett County-Dallas County-TX
3256,Gwinnett County-Lee County-FL-1819,"Lee County, FL",1819,2018,2019,164,3556000,103,4694000,61,-1138000,Gwinnett County,Gwinnett County-Lee County-FL
3257,Gwinnett County-Tarrant County-TX-1819,"Tarrant County, TX",1819,2018,2019,157,3149000,126,4139000,31,-990000,Gwinnett County,Gwinnett County-Tarrant County-TX
3258,Gwinnett County-Bibb County-GA-1819,"Bibb County, GA",1819,2018,2019,150,2741000,102,1724000,48,1017000,Gwinnett County,Gwinnett County-Bibb County-GA
3259,Gwinnett County-Clark County-NV-1819,"Clark County, NV",1819,2018,2019,151,3780000,166,3769000,-15,11000,Gwinnett County,Gwinnett County-Clark County-NV
3260,Gwinnett County-Prince George's County-MD-1819,"Prince George's County, MD",1819,2018,2019,137,3385000,97,1749000,40,1636000,Gwinnett County,Gwinnett County-Prince George's County-MD
3261,Gwinnett County-Bergen County-NJ-1819,"Bergen County, NJ",1819,2018,2019,158,4630000,58,1235000,100,3395000,Gwinnett County,Gwinnett County-Bergen County-NJ
3262,Gwinnett County-Hamilton County-TN-1819,"Hamilton County, TN",1819,2018,2019,129,2921000,94,3052000,35,-131000,Gwinnett County,Gwinnett County-Hamilton County-TN
3263,Gwinnett County-Philadelphia County-PA-1819,"Philadelphia County, PA",1819,2018,2019,173,2474000,57,1048000,116,1426000,Gwinnett County,Gwinnett County-Philadelphia County-PA
3264,Gwinnett County-Greenville County-SC-1819,"Greenville County, SC",1819,2018,2019,133,3579000,119,3345000,14,234000,Gwinnett County,Gwinnett County-Greenville County-SC
3265,Gwinnett County-Marion County-IN-1819,"Marion County, IN",1819,2018,2019,146,2094000,64,1232000,82,862000,Gwinnett County,Gwinnett County-Marion County-IN
3266,Gwinnett County-Richland County-SC-1819,"Richland County, SC",1819,2018,2019,117,3268000,101,1618000,16,1650000,Gwinnett County,Gwinnett County-Richland County-SC
3267,Gwinnett County-Columbia County-GA-1819,"Columbia County, GA",1819,2018,2019,125,3868000,101,3219000,24,649000,Gwinnett County,Gwinnett County-Columbia County-GA
3268,Gwinnett County-Coweta County-GA-1819,"Coweta County, GA",1819,2018,2019,131,3142000,227,6718000,-96,-3576000,Gwinnett County,Gwinnett County-Coweta County-GA
3269,Gwinnett County-Cuyahoga County-OH-1819,"Cuyahoga County, OH",1819,2018,2019,118,4023000,65,1946000,53,2077000,Gwinnett County,Gwinnett County-Cuyahoga County-OH
3270,Gwinnett County-Fairfax County-VA-1819,"Fairfax County, VA",1819,2018,2019,100,4410000,85,3259000,15,1151000,Gwinnett County,Gwinnett County-Fairfax County-VA
3271,Gwinnett County-Brevard County-FL-1819,"Brevard County, FL",1819,2018,2019,117,2479000,118,4954000,-1,-2475000,Gwinnett County,Gwinnett County-Brevard County-FL
3272,Gwinnett County-King County-WA-1819,"King County, WA",1819,2018,2019,104,2907000,117,6325000,-13,-3418000,Gwinnett County,Gwinnett County-King County-WA
3273,Gwinnett County-Carroll County-GA-1819,"Carroll County, GA",1819,2018,2019,96,2935000,108,2433000,-12,502000,Gwinnett County,Gwinnett County-Carroll County-GA
3274,Gwinnett County-Montgomery County-MD-1819,"Montgomery County, MD",1819,2018,2019,106,3330000,90,2871000,16,459000,Gwinnett County,Gwinnett County-Montgomery County-MD
3275,Gwinnett County-Pinellas County-FL-1819,"Pinellas County, FL",1819,2018,2019,86,2233000,145,8377000,-59,-6144000,Gwinnett County,Gwinnett County-Pinellas County-FL
3276,Gwinnett County-Wayne County-MI-1819,"Wayne County, MI",1819,2018,2019,111,2521000,69,2512000,42,9000,Gwinnett County,Gwinnett County-Wayne County-MI
3277,Gwinnett County-Santa Clara County-CA-1819,"Santa Clara County, CA",1819,2018,2019,104,6264000,81,3610000,23,2654000,Gwinnett County,Gwinnett County-Santa Clara County-CA
3278,Gwinnett County-Houston County-GA-1819,"Houston County, GA",1819,2018,2019,110,2427000,109,2147000,1,280000,Gwinnett County,Gwinnett County-Houston County-GA
3279,Gwinnett County-Charleston County-SC-1819,"Charleston County, SC",1819,2018,2019,100,2172000,86,2728000,14,-556000,Gwinnett County,Gwinnett County-Charleston County-SC
3280,Gwinnett County-Hennepin County-MN-1819,"Hennepin County, MN",1819,2018,2019,103,2394000,65,1575000,38,819000,Gwinnett County,Gwinnett County-Hennepin County-MN
3281,Gwinnett County-Bay County-FL-1819,"Bay County, FL",1819,2018,2019,94,2297000,73,3808000,21,-1511000,Gwinnett County,Gwinnett County-Bay County-FL
3282,Gwinnett County-Seminole County-FL-1819,"Seminole County, FL",1819,2018,2019,94,2468000,89,2566000,5,-98000,Gwinnett County,Gwinnett County-Seminole County-FL
3283,Gwinnett County-Bulloch County-GA-1819,"Bulloch County, GA",1819,2018,2019,68,1488000,46,1001000,22,487000,Gwinnett County,Gwinnett County-Bulloch County-GA
3284,Gwinnett County-Middlesex County-NJ-1819,"Middlesex County, NJ",1819,2018,2019,91,2571000,44,1158000,47,1413000,Gwinnett County,Gwinnett County-Middlesex County-NJ
3285,Gwinnett County-Fairfield County-CT-1819,"Fairfield County, CT",1819,2018,2019,75,1807000,41,1694000,34,113000,Gwinnett County,Gwinnett County-Fairfield County-CT
3286,Gwinnett County-Escambia County-FL-1819,"Escambia County, FL",1819,2018,2019,82,1894000,83,3487000,-1,-1593000,Gwinnett County,Gwinnett County-Escambia County-FL
3287,Gwinnett County-Bartow County-GA-1819,"Bartow County, GA",1819,2018,2019,98,1471000,99,2619000,-1,-1148000,Gwinnett County,Gwinnett County-Bartow County-GA
3288,Gwinnett County-Lumpkin County-GA-1819,"Lumpkin County, GA",1819,2018,2019,67,1529000,78,3001000,-11,-1472000,Gwinnett County,Gwinnett County-Lumpkin County-GA
3289,Gwinnett County-Baltimore County-MD-1819,"Baltimore County, MD",1819,2018,2019,100,1796000,40,758000,60,1038000,Gwinnett County,Gwinnett County-Baltimore County-MD
3290,Gwinnett County-Oakland County-MI-1819,"Oakland County, MI",1819,2018,2019,89,2613000,66,1830000,23,783000,Gwinnett County,Gwinnett County-Oakland County-MI
3291,Gwinnett County-Guilford County-NC-1819,"Guilford County, NC",1819,2018,2019,93,1834000,54,1476000,39,358000,Gwinnett County,Gwinnett County-Guilford County-NC
3292,Gwinnett County-Franklin County-OH-1819,"Franklin County, OH",1819,2018,2019,97,1820000,92,1579000,5,241000,Gwinnett County,Gwinnett County-Franklin County-OH
3293,Gwinnett County-Travis County-TX-1819,"Travis County, TX",1819,2018,2019,81,1859000,87,2820000,-6,-961000,Gwinnett County,Gwinnett County-Travis County-TX
3294,Gwinnett County-Madison County-AL-1819,"Madison County, AL",1819,2018,2019,86,3046000,68,1141000,18,1905000,Gwinnett County,Gwinnett County-Madison County-AL
3295,Gwinnett County-Riverside County-CA-1819,"Riverside County, CA",1819,2018,2019,93,2563000,49,999000,44,1564000,Gwinnett County,Gwinnett County-Riverside County-CA
3296,Gwinnett County-San Bernardino County-CA-1819,"San Bernardino County, CA",1819,2018,2019,73,1526000,60,825000,13,701000,Gwinnett County,Gwinnett County-San Bernardino County-CA
3297,Gwinnett County-Honolulu County-HI-1819,"Honolulu County, HI",1819,2018,2019,74,2151000,51,1532000,23,619000,Gwinnett County,Gwinnett County-Honolulu County-HI
3298,Gwinnett County-Middlesex County-MA-1819,"Middlesex County, MA",1819,2018,2019,94,2145000,54,3794000,40,-1649000,Gwinnett County,Gwinnett County-Middlesex County-MA
3299,Gwinnett County-Lee County-AL-1819,"Lee County, AL",1819,2018,2019,81,2824000,53,1318000,28,1506000,Gwinnett County,Gwinnett County-Lee County-AL
3300,Gwinnett County-DuPage County-IL-1819,"DuPage County, IL",1819,2018,2019,85,2386000,63,1531000,22,855000,Gwinnett County,Gwinnett County-DuPage County-IL
3301,Gwinnett County-Montgomery County-AL-1819,"Montgomery County, AL",1819,2018,2019,84,1771000,88,2158000,-4,-387000,Gwinnett County,Gwinnett County-Montgomery County-AL
3302,Gwinnett County-Lowndes County-GA-1819,"Lowndes County, GA",1819,2018,2019,67,1378000,66,1409000,1,-31000,Gwinnett County,Gwinnett County-Lowndes County-GA
3303,Gwinnett County-Beaufort County-SC-1819,"Beaufort County, SC",1819,2018,2019,70,2162000,78,6305000,-8,-4143000,Gwinnett County,Gwinnett County-Beaufort County-SC
3304,Gwinnett County-Alameda County-CA-1819,"Alameda County, CA",1819,2018,2019,65,2938000,59,2035000,6,903000,Gwinnett County,Gwinnett County-Alameda County-CA
3305,Gwinnett County-Cumberland County-NC-1819,"Cumberland County, NC",1819,2018,2019,87,1574000,30,647000,57,927000,Gwinnett County,Gwinnett County-Cumberland County-NC
3306,Gwinnett County-Durham County-NC-1819,"Durham County, NC",1819,2018,2019,67,1668000,47,1149000,20,519000,Gwinnett County,Gwinnett County-Durham County-NC
3307,Gwinnett County-Dougherty County-GA-1819,"Dougherty County, GA",1819,2018,2019,89,1259000,55,923000,34,336000,Gwinnett County,Gwinnett County-Dougherty County-GA
3308,Gwinnett County-Polk County-FL-1819,"Polk County, FL",1819,2018,2019,76,1474000,118,3344000,-42,-1870000,Gwinnett County,Gwinnett County-Polk County-FL
3309,Gwinnett County-Monroe County-NY-1819,"Monroe County, NY",1819,2018,2019,75,1708000,38,954000,37,754000,Gwinnett County,Gwinnett County-Monroe County-NY
3310,Gwinnett County-Oconee County-GA-1819,"Oconee County, GA",1819,2018,2019,71,2297000,263,15689000,-192,-13392000,Gwinnett County,Gwinnett County-Oconee County-GA
3311,Gwinnett County-St. Louis County-MO-1819,"St. Louis County, MO",1819,2018,2019,81,1842000,47,2011000,34,-169000,Gwinnett County,Gwinnett County-St. Louis County-MO
3312,Gwinnett County-Knox County-TN-1819,"Knox County, TN",1819,2018,2019,50,1273000,91,2042000,-41,-769000,Gwinnett County,Gwinnett County-Knox County-TN
3313,Gwinnett County-Sacramento County-CA-1819,"Sacramento County, CA",1819,2018,2019,79,1816000,38,1011000,41,805000,Gwinnett County,Gwinnett County-Sacramento County-CA
3314,Gwinnett County-Lake County-FL-1819,"Lake County, FL",1819,2018,2019,73,2038000,59,1344000,14,694000,Gwinnett County,Gwinnett County-Lake County-FL
3315,Gwinnett County-Pasco County-FL-1819,"Pasco County, FL",1819,2018,2019,69,2303000,78,1972000,-9,331000,Gwinnett County,Gwinnett County-Pasco County-FL
3316,Gwinnett County-Habersham County-GA-1819,"Habersham County, GA",1819,2018,2019,62,1915000,141,6310000,-79,-4395000,Gwinnett County,Gwinnett County-Habersham County-GA
3317,Gwinnett County-Bexar County-TX-1819,"Bexar County, TX",1819,2018,2019,81,1559000,107,3195000,-26,-1636000,Gwinnett County,Gwinnett County-Bexar County-TX
3318,Gwinnett County-Osceola County-FL-1819,"Osceola County, FL",1819,2018,2019,86,1346000,57,1343000,29,3000,Gwinnett County,Gwinnett County-Osceola County-FL
3319,Gwinnett County-District of Columbia-DC-1819,"District of Columbia, DC",1819,2018,2019,45,1922000,53,2018000,-8,-96000,Gwinnett County,Gwinnett County-District of Columbia-DC
3320,Gwinnett County-Jefferson County-KY-1819,"Jefferson County, KY",1819,2018,2019,53,1482000,38,1246000,15,236000,Gwinnett County,Gwinnett County-Jefferson County-KY
3321,Gwinnett County-Erie County-NY-1819,"Erie County, NY",1819,2018,2019,70,1581000,38,719000,32,862000,Gwinnett County,Gwinnett County-Erie County-NY
3322,Gwinnett County-Collin County-TX-1819,"Collin County, TX",1819,2018,2019,82,2919000,135,5757000,-53,-2838000,Gwinnett County,Gwinnett County-Collin County-TX
3323,Gwinnett County-Prince William County-VA-1819,"Prince William County, VA",1819,2018,2019,62,2021000,71,2678000,-9,-657000,Gwinnett County,Gwinnett County-Prince William County-VA
3324,Gwinnett County-Leon County-FL-1819,"Leon County, FL",1819,2018,2019,55,1091000,50,1654000,5,-563000,Gwinnett County,Gwinnett County-Leon County-FL
3325,Gwinnett County-St. Lucie County-FL-1819,"St. Lucie County, FL",1819,2018,2019,75,1502000,75,1344000,0,158000,Gwinnett County,Gwinnett County-St. Lucie County-FL
3326,Gwinnett County-Floyd County-GA-1819,"Floyd County, GA",1819,2018,2019,54,1723000,73,1975000,-19,-252000,Gwinnett County,Gwinnett County-Floyd County-GA
3327,Gwinnett County-Spartanburg County-SC-1819,"Spartanburg County, SC",1819,2018,2019,67,1571000,42,1184000,25,387000,Gwinnett County,Gwinnett County-Spartanburg County-SC
3328,Gwinnett County-Dawson County-GA-1819,"Dawson County, GA",1819,2018,2019,47,1381000,147,4676000,-100,-3295000,Gwinnett County,Gwinnett County-Dawson County-GA
3329,Gwinnett County-Jefferson Parish-LA-1819,"Jefferson Parish, LA",1819,2018,2019,57,1312000,53,709000,4,603000,Gwinnett County,Gwinnett County-Jefferson Parish-LA
3330,Gwinnett County-Orleans Parish-LA-1819,"Orleans Parish, LA",1819,2018,2019,62,1155000,43,771000,19,384000,Gwinnett County,Gwinnett County-Orleans Parish-LA
3331,Gwinnett County-Denton County-TX-1819,"Denton County, TX",1819,2018,2019,56,2356000,97,4000000,-41,-1644000,Gwinnett County,Gwinnett County-Denton County-TX
3332,Gwinnett County-Hamilton County-OH-1819,"Hamilton County, OH",1819,2018,2019,62,1678000,41,1105000,21,573000,Gwinnett County,Gwinnett County-Hamilton County-OH
3333,Gwinnett County-Fort Bend County-TX-1819,"Fort Bend County, TX",1819,2018,2019,58,1195000,84,2549000,-26,-1354000,Gwinnett County,Gwinnett County-Fort Bend County-TX
3334,Gwinnett County-Mobile County-AL-1819,"Mobile County, AL",1819,2018,2019,59,1435000,45,1268000,14,167000,Gwinnett County,Gwinnett County-Mobile County-AL
3335,Gwinnett County-Volusia County-FL-1819,"Volusia County, FL",1819,2018,2019,49,1075000,92,6629000,-43,-5554000,Gwinnett County,Gwinnett County-Volusia County-FL
3336,Gwinnett County-Pierce County-WA-1819,"Pierce County, WA",1819,2018,2019,59,970000,42,818000,17,152000,Gwinnett County,Gwinnett County-Pierce County-WA
3337,Gwinnett County-El Paso County-CO-1819,"El Paso County, CO",1819,2018,2019,61,1710000,52,1005000,9,705000,Gwinnett County,Gwinnett County-El Paso County-CO
3338,Gwinnett County-Okaloosa County-FL-1819,"Okaloosa County, FL",1819,2018,2019,51,1530000,48,1535000,3,-5000,Gwinnett County,Gwinnett County-Okaloosa County-FL
3339,Gwinnett County-Sarasota County-FL-1819,"Sarasota County, FL",1819,2018,2019,43,941000,63,2632000,-20,-1691000,Gwinnett County,Gwinnett County-Sarasota County-FL
3340,Gwinnett County-Allegheny County-PA-1819,"Allegheny County, PA",1819,2018,2019,56,1742000,73,1383000,-17,359000,Gwinnett County,Gwinnett County-Allegheny County-PA
3341,Gwinnett County-Denver County-CO-1819,"Denver County, CO",1819,2018,2019,42,1221000,82,2883000,-40,-1662000,Gwinnett County,Gwinnett County-Denver County-CO
3342,Gwinnett County-Arapahoe County-CO-1819,"Arapahoe County, CO",1819,2018,2019,53,1537000,55,1454000,-2,83000,Gwinnett County,Gwinnett County-Arapahoe County-CO
3343,Gwinnett County-Onslow County-NC-1819,"Onslow County, NC",1819,2018,2019,60,978000,53,956000,7,22000,Gwinnett County,Gwinnett County-Onslow County-NC
3344,Gwinnett County-Rutherford County-TN-1819,"Rutherford County, TN",1819,2018,2019,54,1663000,43,1651000,11,12000,Gwinnett County,Gwinnett County-Rutherford County-TN
3345,Gwinnett County-Anderson County-SC-1819,"Anderson County, SC",1819,2018,2019,45,786000,65,2755000,-20,-1969000,Gwinnett County,Gwinnett County-Anderson County-SC
3346,Gwinnett County-Marion County-FL-1819,"Marion County, FL",1819,2018,2019,45,1366000,43,1415000,2,-49000,Gwinnett County,Gwinnett County-Marion County-FL
3347,Gwinnett County-Glynn County-GA-1819,"Glynn County, GA",1819,2018,2019,38,1330000,52,3531000,-14,-2201000,Gwinnett County,Gwinnett County-Glynn County-GA
3348,Gwinnett County-Shelby County-AL-1819,"Shelby County, AL",1819,2018,2019,50,1029000,43,1335000,7,-306000,Gwinnett County,Gwinnett County-Shelby County-AL
3349,Gwinnett County-St. Johns County-FL-1819,"St. Johns County, FL",1819,2018,2019,38,1412000,84,5372000,-46,-3960000,Gwinnett County,Gwinnett County-St. Johns County-FL
3350,Gwinnett County-Manatee County-FL-1819,"Manatee County, FL",1819,2018,2019,42,1390000,52,2435000,-10,-1045000,Gwinnett County,Gwinnett County-Manatee County-FL
3351,Gwinnett County-Spalding County-GA-1819,"Spalding County, GA",1819,2018,2019,40,902000,70,1830000,-30,-928000,Gwinnett County,Gwinnett County-Spalding County-GA
3352,Gwinnett County-Stephens County-GA-1819,"Stephens County, GA",1819,2018,2019,45,672000,60,1685000,-15,-1013000,Gwinnett County,Gwinnett County-Stephens County-GA
3353,Gwinnett County-Troup County-GA-1819,"Troup County, GA",1819,2018,2019,42,769000,51,1154000,-9,-385000,Gwinnett County,Gwinnett County-Troup County-GA
3354,Gwinnett County-Baltimore city-MD-1819,"Baltimore city, MD",1819,2018,2019,44,697000,36,519000,8,178000,Gwinnett County,Gwinnett County-Baltimore city-MD
3355,Gwinnett County-Milwaukee County-WI-1819,"Milwaukee County, WI",1819,2018,2019,46,706000,33,906000,13,-200000,Gwinnett County,Gwinnett County-Milwaukee County-WI
3356,Gwinnett County-Pickens County-GA-1819,"Pickens County, GA",1819,2018,2019,31,1029000,67,2585000,-36,-1556000,Gwinnett County,Gwinnett County-Pickens County-GA
3357,Gwinnett County-White County-GA-1819,"White County, GA",1819,2018,2019,38,1086000,105,3650000,-67,-2564000,Gwinnett County,Gwinnett County-White County-GA
3359,Henry County-Clayton County-GA-1819,"Clayton County, GA",1819,2018,2019,4902,82958000,2819,43647000,2083,39311000,Henry County,Henry County-Clayton County-GA
3360,Henry County-DeKalb County-GA-1819,"DeKalb County, GA",1819,2018,2019,1786,35938000,1095,21598000,691,14340000,Henry County,Henry County-DeKalb County-GA
3361,Henry County-Fulton County-GA-1819,"Fulton County, GA",1819,2018,2019,1538,34248000,1185,33794000,353,454000,Henry County,Henry County-Fulton County-GA
3362,Henry County-Spalding County-GA-1819,"Spalding County, GA",1819,2018,2019,731,13259000,996,20122000,-265,-6863000,Henry County,Henry County-Spalding County-GA
3363,Henry County-Gwinnett County-GA-1819,"Gwinnett County, GA",1819,2018,2019,632,12259000,534,11823000,98,436000,Henry County,Henry County-Gwinnett County-GA
3364,Henry County-Cobb County-GA-1819,"Cobb County, GA",1819,2018,2019,559,14102000,540,21602000,19,-7500000,Henry County,Henry County-Cobb County-GA
3365,Henry County-Rockdale County-GA-1819,"Rockdale County, GA",1819,2018,2019,499,11560000,352,6954000,147,4606000,Henry County,Henry County-Rockdale County-GA
3366,Henry County-Newton County-GA-1819,"Newton County, GA",1819,2018,2019,426,7766000,437,9088000,-11,-1322000,Henry County,Henry County-Newton County-GA
3367,Henry County-Butts County-GA-1819,"Butts County, GA",1819,2018,2019,314,5489000,519,13407000,-205,-7918000,Henry County,Henry County-Butts County-GA
3368,Henry County-Fayette County-GA-1819,"Fayette County, GA",1819,2018,2019,264,7035000,428,16987000,-164,-9952000,Henry County,Henry County-Fayette County-GA
3369,Henry County-Bibb County-GA-1819,"Bibb County, GA",1819,2018,2019,246,5759000,107,2757000,139,3002000,Henry County,Henry County-Bibb County-GA
3370,Henry County-Miami-Dade County-FL-1819,"Miami-Dade County, FL",1819,2018,2019,204,3868000,57,1052000,147,2816000,Henry County,Henry County-Miami-Dade County-FL
3371,Henry County-Broward County-FL-1819,"Broward County, FL",1819,2018,2019,192,3951000,78,1596000,114,2355000,Henry County,Henry County-Broward County-FL
3372,Henry County-Coweta County-GA-1819,"Coweta County, GA",1819,2018,2019,141,3238000,339,12768000,-198,-9530000,Henry County,Henry County-Coweta County-GA
3373,Henry County-Douglas County-GA-1819,"Douglas County, GA",1819,2018,2019,169,3198000,133,2306000,36,892000,Henry County,Henry County-Douglas County-GA
3374,Henry County-Houston County-GA-1819,"Houston County, GA",1819,2018,2019,156,3924000,89,1649000,67,2275000,Henry County,Henry County-Houston County-GA
3375,Henry County-Kings County-NY-1819,"Kings County, NY",1819,2018,2019,118,2631000,45,608000,73,2023000,Henry County,Henry County-Kings County-NY
3376,Henry County-Chatham County-GA-1819,"Chatham County, GA",1819,2018,2019,118,1708000,52,1226000,66,482000,Henry County,Henry County-Chatham County-GA
3377,Henry County-Cook County-IL-1819,"Cook County, IL",1819,2018,2019,102,3453000,47,741000,55,2712000,Henry County,Henry County-Cook County-IL
3378,Henry County-Muscogee County-GA-1819,"Muscogee County, GA",1819,2018,2019,90,1552000,40,741000,50,811000,Henry County,Henry County-Muscogee County-GA
3379,Henry County-Monroe County-GA-1819,"Monroe County, GA",1819,2018,2019,97,1763000,209,6535000,-112,-4772000,Henry County,Henry County-Monroe County-GA
3380,Henry County-Los Angeles County-CA-1819,"Los Angeles County, CA",1819,2018,2019,69,2716000,42,865000,27,1851000,Henry County,Henry County-Los Angeles County-CA
3381,Henry County-Duval County-FL-1819,"Duval County, FL",1819,2018,2019,77,1265000,69,1712000,8,-447000,Henry County,Henry County-Duval County-FL
3382,Henry County-Orange County-FL-1819,"Orange County, FL",1819,2018,2019,70,1878000,77,1407000,-7,471000,Henry County,Henry County-Orange County-FL
3383,Henry County-Lamar County-GA-1819,"Lamar County, GA",1819,2018,2019,74,1839000,228,5963000,-154,-4124000,Henry County,Henry County-Lamar County-GA
3384,Henry County-Walton County-GA-1819,"Walton County, GA",1819,2018,2019,70,1576000,84,1726000,-14,-150000,Henry County,Henry County-Walton County-GA
3385,Henry County-Cherokee County-GA-1819,"Cherokee County, GA",1819,2018,2019,58,1158000,130,4691000,-72,-3533000,Henry County,Henry County-Cherokee County-GA
3386,Henry County-Paulding County-GA-1819,"Paulding County, GA",1819,2018,2019,66,1638000,103,2158000,-37,-520000,Henry County,Henry County-Paulding County-GA
3387,Henry County-Carroll County-GA-1819,"Carroll County, GA",1819,2018,2019,62,930000,52,1303000,10,-373000,Henry County,Henry County-Carroll County-GA
3388,Henry County-Palm Beach County-FL-1819,"Palm Beach County, FL",1819,2018,2019,68,1098000,51,833000,17,265000,Henry County,Henry County-Palm Beach County-FL
3389,Henry County-Pike County-GA-1819,"Pike County, GA",1819,2018,2019,66,1344000,210,6322000,-144,-4978000,Henry County,Henry County-Pike County-GA
3390,Henry County-Maricopa County-AZ-1819,"Maricopa County, AZ",1819,2018,2019,41,779000,56,1203000,-15,-424000,Henry County,Henry County-Maricopa County-AZ
3391,Henry County-Forsyth County-GA-1819,"Forsyth County, GA",1819,2018,2019,47,1886000,97,3238000,-50,-1352000,Henry County,Henry County-Forsyth County-GA
3392,Henry County-Lowndes County-GA-1819,"Lowndes County, GA",1819,2018,2019,52,633000,54,693000,-2,-60000,Henry County,Henry County-Lowndes County-GA
3393,Henry County-Hillsborough County-FL-1819,"Hillsborough County, FL",1819,2018,2019,47,572000,62,1815000,-15,-1243000,Henry County,Henry County-Hillsborough County-FL
3394,Henry County-Jasper County-GA-1819,"Jasper County, GA",1819,2018,2019,44,807000,135,4377000,-91,-3570000,Henry County,Henry County-Jasper County-GA
3395,Henry County-Prince George's County-MD-1819,"Prince George's County, MD",1819,2018,2019,30,1551000,37,1303000,-7,248000,Henry County,Henry County-Prince George's County-MD
3396,Henry County-San Diego County-CA-1819,"San Diego County, CA",1819,2018,2019,42,1025000,43,905000,-1,120000,Henry County,Henry County-San Diego County-CA
3397,Henry County-Troup County-GA-1819,"Troup County, GA",1819,2018,2019,40,772000,34,1119000,6,-347000,Henry County,Henry County-Troup County-GA
3398,Henry County-Mecklenburg County-NC-1819,"Mecklenburg County, NC",1819,2018,2019,43,821000,49,1053000,-6,-232000,Henry County,Henry County-Mecklenburg County-NC
3400,Rockdale County-DeKalb County-GA-1819,"DeKalb County, GA",1819,2018,2019,2027,36977000,1190,20291000,837,16686000,Rockdale County,Rockdale County-DeKalb County-GA
3401,Rockdale County-Newton County-GA-1819,"Newton County, GA",1819,2018,2019,1371,21869000,1697,28294000,-326,-6425000,Rockdale County,Rockdale County-Newton County-GA
3402,Rockdale County-Gwinnett County-GA-1819,"Gwinnett County, GA",1819,2018,2019,789,15507000,589,12460000,200,3047000,Rockdale County,Rockdale County-Gwinnett County-GA
3403,Rockdale County-Fulton County-GA-1819,"Fulton County, GA",1819,2018,2019,348,7323000,384,9694000,-36,-2371000,Rockdale County,Rockdale County-Fulton County-GA
3404,Rockdale County-Henry County-GA-1819,"Henry County, GA",1819,2018,2019,352,6954000,499,11560000,-147,-4606000,Rockdale County,Rockdale County-Henry County-GA
3405,Rockdale County-Clayton County-GA-1819,"Clayton County, GA",1819,2018,2019,249,3978000,270,3815000,-21,163000,Rockdale County,Rockdale County-Clayton County-GA
3406,Rockdale County-Walton County-GA-1819,"Walton County, GA",1819,2018,2019,212,3475000,275,5964000,-63,-2489000,Rockdale County,Rockdale County-Walton County-GA
3407,Rockdale County-Cobb County-GA-1819,"Cobb County, GA",1819,2018,2019,158,2929000,163,4883000,-5,-1954000,Rockdale County,Rockdale County-Cobb County-GA
3408,Rockdale County-Broward County-FL-1819,"Broward County, FL",1819,2018,2019,54,1141000,41,981000,13,160000,Rockdale County,Rockdale County-Broward County-FL
3409,Rockdale County-Douglas County-GA-1819,"Douglas County, GA",1819,2018,2019,51,679000,54,966000,-3,-287000,Rockdale County,Rockdale County-Douglas County-GA
3410,Rockdale County-Miami-Dade County-FL-1819,"Miami-Dade County, FL",1819,2018,2019,44,900000,49,675000,-5,225000,Rockdale County,Rockdale County-Miami-Dade County-FL
3412,Cherokee County-Cobb County-GA-1920,"Cobb County, GA",1920,2019,2020,5364,211013000,2874,88012000,2490,123001000,Cherokee County,Cherokee County-Cobb County-GA
3413,Cherokee County-Fulton County-GA-1920,"Fulton County, GA",1920,2019,2020,2757,134106000,1219,69584000,1538,64522000,Cherokee County,Cherokee County-Fulton County-GA
3414,Cherokee County-Forsyth County-GA-1920,"Forsyth County, GA",1920,2019,2020,941,46300000,662,28971000,279,17329000,Cherokee County,Cherokee County-Forsyth County-GA
3415,Cherokee County-Gwinnett County-GA-1920,"Gwinnett County, GA",1920,2019,2020,759,27065000,444,14883000,315,12182000,Cherokee County,Cherokee County-Gwinnett County-GA
3416,Cherokee County-DeKalb County-GA-1920,"DeKalb County, GA",1920,2019,2020,447,20099000,247,9480000,200,10619000,Cherokee County,Cherokee County-DeKalb County-GA
3417,Cherokee County-Bartow County-GA-1920,"Bartow County, GA",1920,2019,2020,518,12462000,1049,27922000,-531,-15460000,Cherokee County,Cherokee County-Bartow County-GA
3418,Cherokee County-Pickens County-GA-1920,"Pickens County, GA",1920,2019,2020,509,13306000,822,24396000,-313,-11090000,Cherokee County,Cherokee County-Pickens County-GA
3419,Cherokee County-Paulding County-GA-1920,"Paulding County, GA",1920,2019,2020,485,22582000,669,18091000,-184,4491000,Cherokee County,Cherokee County-Paulding County-GA
3420,Cherokee County-Gilmer County-GA-1920,"Gilmer County, GA",1920,2019,2020,172,5656000,161,6819000,11,-1163000,Cherokee County,Cherokee County-Gilmer County-GA
3421,Cherokee County-Henry County-GA-1920,"Henry County, GA",1920,2019,2020,151,7595000,67,1795000,84,5800000,Cherokee County,Cherokee County-Henry County-GA
3422,Cherokee County-Broward County-FL-1920,"Broward County, FL",1920,2019,2020,136,5326000,59,1892000,77,3434000,Cherokee County,Cherokee County-Broward County-FL
3423,Cherokee County-Douglas County-GA-1920,"Douglas County, GA",1920,2019,2020,126,3775000,91,1557000,35,2218000,Cherokee County,Cherokee County-Douglas County-GA
3424,Cherokee County-Hall County-GA-1920,"Hall County, GA",1920,2019,2020,93,3355000,193,8928000,-100,-5573000,Cherokee County,Cherokee County-Hall County-GA
3425,Cherokee County-Clayton County-GA-1920,"Clayton County, GA",1920,2019,2020,117,1877000,45,920000,72,957000,Cherokee County,Cherokee County-Clayton County-GA
3426,Cherokee County-Hillsborough County-FL-1920,"Hillsborough County, FL",1920,2019,2020,112,2921000,50,2340000,62,581000,Cherokee County,Cherokee County-Hillsborough County-FL
3427,Cherokee County-Miami-Dade County-FL-1920,"Miami-Dade County, FL",1920,2019,2020,91,2326000,43,709000,48,1617000,Cherokee County,Cherokee County-Miami-Dade County-FL
3428,Cherokee County-Palm Beach County-FL-1920,"Palm Beach County, FL",1920,2019,2020,100,3246000,73,2326000,27,920000,Cherokee County,Cherokee County-Palm Beach County-FL
3429,Cherokee County-Coweta County-GA-1920,"Coweta County, GA",1920,2019,2020,83,3670000,54,1825000,29,1845000,Cherokee County,Cherokee County-Coweta County-GA
3430,Cherokee County-Floyd County-GA-1920,"Floyd County, GA",1920,2019,2020,69,2350000,108,2577000,-39,-227000,Cherokee County,Cherokee County-Floyd County-GA
3431,Cherokee County-Pinellas County-FL-1920,"Pinellas County, FL",1920,2019,2020,67,2588000,53,2269000,14,319000,Cherokee County,Cherokee County-Pinellas County-FL
3432,Cherokee County-Maricopa County-AZ-1920,"Maricopa County, AZ",1920,2019,2020,79,3630000,62,2845000,17,785000,Cherokee County,Cherokee County-Maricopa County-AZ
3433,Cherokee County-Fannin County-GA-1920,"Fannin County, GA",1920,2019,2020,67,2648000,82,6675000,-15,-4027000,Cherokee County,Cherokee County-Fannin County-GA
3434,Cherokee County-Orange County-FL-1920,"Orange County, FL",1920,2019,2020,54,1874000,55,2460000,-1,-586000,Cherokee County,Cherokee County-Orange County-FL
3435,Cherokee County-Dawson County-GA-1920,"Dawson County, GA",1920,2019,2020,58,2015000,127,3352000,-69,-1337000,Cherokee County,Cherokee County-Dawson County-GA
3436,Cherokee County-Carroll County-GA-1920,"Carroll County, GA",1920,2019,2020,62,1374000,64,1480000,-2,-106000,Cherokee County,Cherokee County-Carroll County-GA
3437,Cherokee County-Chatham County-GA-1920,"Chatham County, GA",1920,2019,2020,70,2538000,52,2209000,18,329000,Cherokee County,Cherokee County-Chatham County-GA
3438,Cherokee County-Duval County-FL-1920,"Duval County, FL",1920,2019,2020,54,1753000,40,1562000,14,191000,Cherokee County,Cherokee County-Duval County-FL
3439,Cherokee County-Gordon County-GA-1920,"Gordon County, GA",1920,2019,2020,54,1383000,156,6936000,-102,-5553000,Cherokee County,Cherokee County-Gordon County-GA
3440,Cherokee County-Lumpkin County-GA-1920,"Lumpkin County, GA",1920,2019,2020,47,2350000,59,1222000,-12,1128000,Cherokee County,Cherokee County-Lumpkin County-GA
3441,Cherokee County-Clarke County-GA-1920,"Clarke County, GA",1920,2019,2020,44,989000,30,908000,14,81000,Cherokee County,Cherokee County-Clarke County-GA
3442,Cherokee County-Harris County-TX-1920,"Harris County, TX",1920,2019,2020,55,2626000,27,914000,28,1712000,Cherokee County,Cherokee County-Harris County-TX
3443,Cherokee County-Lee County-FL-1920,"Lee County, FL",1920,2019,2020,53,2217000,54,1753000,-1,464000,Cherokee County,Cherokee County-Lee County-FL
3444,Cherokee County-Fayette County-GA-1920,"Fayette County, GA",1920,2019,2020,46,1972000,42,1946000,4,26000,Cherokee County,Cherokee County-Fayette County-GA
3445,Cherokee County-Houston County-GA-1920,"Houston County, GA",1920,2019,2020,44,1599000,47,1362000,-3,237000,Cherokee County,Cherokee County-Houston County-GA
3446,Cherokee County-Brevard County-FL-1920,"Brevard County, FL",1920,2019,2020,40,935000,49,1453000,-9,-518000,Cherokee County,Cherokee County-Brevard County-FL
3447,Cherokee County-Polk County-GA-1920,"Polk County, GA",1920,2019,2020,25,609000,45,691000,-20,-82000,Cherokee County,Cherokee County-Polk County-GA
3448,Cherokee County-Mecklenburg County-NC-1920,"Mecklenburg County, NC",1920,2019,2020,32,1504000,45,1878000,-13,-374000,Cherokee County,Cherokee County-Mecklenburg County-NC
3449,Cherokee County-Hamilton County-TN-1920,"Hamilton County, TN",1920,2019,2020,37,1742000,76,2153000,-39,-411000,Cherokee County,Cherokee County-Hamilton County-TN
3451,Clayton County-Fulton County-GA-1920,"Fulton County, GA",1920,2019,2020,7522,95274000,6869,93887000,653,1387000,Clayton County,Clayton County-Fulton County-GA
3452,Clayton County-DeKalb County-GA-1920,"DeKalb County, GA",1920,2019,2020,3566,46808000,2877,38594000,689,8214000,Clayton County,Clayton County-DeKalb County-GA
3453,Clayton County-Henry County-GA-1920,"Henry County, GA",1920,2019,2020,2897,46331000,5158,89500000,-2261,-43169000,Clayton County,Clayton County-Henry County-GA
3454,Clayton County-Cobb County-GA-1920,"Cobb County, GA",1920,2019,2020,948,14329000,934,13082000,14,1247000,Clayton County,Clayton County-Cobb County-GA
3455,Clayton County-Gwinnett County-GA-1920,"Gwinnett County, GA",1920,2019,2020,836,11881000,923,14071000,-87,-2190000,Clayton County,Clayton County-Gwinnett County-GA
3456,Clayton County-Fayette County-GA-1920,"Fayette County, GA",1920,2019,2020,573,9717000,1042,48752000,-469,-39035000,Clayton County,Clayton County-Fayette County-GA
3457,Clayton County-Spalding County-GA-1920,"Spalding County, GA",1920,2019,2020,435,5643000,595,10090000,-160,-4447000,Clayton County,Clayton County-Spalding County-GA
3458,Clayton County-Douglas County-GA-1920,"Douglas County, GA",1920,2019,2020,284,4469000,485,7271000,-201,-2802000,Clayton County,Clayton County-Douglas County-GA
3459,Clayton County-Rockdale County-GA-1920,"Rockdale County, GA",1920,2019,2020,264,3571000,311,4729000,-47,-1158000,Clayton County,Clayton County-Rockdale County-GA
3460,Clayton County-Coweta County-GA-1920,"Coweta County, GA",1920,2019,2020,235,4521000,381,7176000,-146,-2655000,Clayton County,Clayton County-Coweta County-GA
3461,Clayton County-Miami-Dade County-FL-1920,"Miami-Dade County, FL",1920,2019,2020,261,2882000,108,1398000,153,1484000,Clayton County,Clayton County-Miami-Dade County-FL
3462,Clayton County-Newton County-GA-1920,"Newton County, GA",1920,2019,2020,212,2843000,284,4320000,-72,-1477000,Clayton County,Clayton County-Newton County-GA
3463,Clayton County-Broward County-FL-1920,"Broward County, FL",1920,2019,2020,175,2678000,129,2028000,46,650000,Clayton County,Clayton County-Broward County-FL
3464,Clayton County-Bibb County-GA-1920,"Bibb County, GA",1920,2019,2020,152,1876000,139,1701000,13,175000,Clayton County,Clayton County-Bibb County-GA
3465,Clayton County-Kings County-NY-1920,"Kings County, NY",1920,2019,2020,126,2435000,50,505000,76,1930000,Clayton County,Clayton County-Kings County-NY
3466,Clayton County-Chatham County-GA-1920,"Chatham County, GA",1920,2019,2020,141,1941000,96,1810000,45,131000,Clayton County,Clayton County-Chatham County-GA
3467,Clayton County-Cook County-IL-1920,"Cook County, IL",1920,2019,2020,134,1737000,111,1292000,23,445000,Clayton County,Clayton County-Cook County-IL
3468,Clayton County-Muscogee County-GA-1920,"Muscogee County, GA",1920,2019,2020,134,1474000,84,1106000,50,368000,Clayton County,Clayton County-Muscogee County-GA
3469,Clayton County-Orange County-FL-1920,"Orange County, FL",1920,2019,2020,128,1898000,77,992000,51,906000,Clayton County,Clayton County-Orange County-FL
3470,Clayton County-Duval County-FL-1920,"Duval County, FL",1920,2019,2020,114,1319000,147,1977000,-33,-658000,Clayton County,Clayton County-Duval County-FL
3471,Clayton County-Paulding County-GA-1920,"Paulding County, GA",1920,2019,2020,119,1833000,131,2238000,-12,-405000,Clayton County,Clayton County-Paulding County-GA
3472,Clayton County-Los Angeles County-CA-1920,"Los Angeles County, CA",1920,2019,2020,109,2108000,85,1454000,24,654000,Clayton County,Clayton County-Los Angeles County-CA
3473,Clayton County-Harris County-TX-1920,"Harris County, TX",1920,2019,2020,89,1149000,95,1420000,-6,-271000,Clayton County,Clayton County-Harris County-TX
3474,Clayton County-Richmond County-GA-1920,"Richmond County, GA",1920,2019,2020,92,1218000,82,1110000,10,108000,Clayton County,Clayton County-Richmond County-GA
3475,Clayton County-Dougherty County-GA-1920,"Dougherty County, GA",1920,2019,2020,83,928000,56,606000,27,322000,Clayton County,Clayton County-Dougherty County-GA
3476,Clayton County-Wayne County-MI-1920,"Wayne County, MI",1920,2019,2020,69,885000,52,491000,17,394000,Clayton County,Clayton County-Wayne County-MI
3477,Clayton County-Bronx County-NY-1920,"Bronx County, NY",1920,2019,2020,71,1310000,70,538000,1,772000,Clayton County,Clayton County-Bronx County-NY
3478,Clayton County-Mecklenburg County-NC-1920,"Mecklenburg County, NC",1920,2019,2020,84,1155000,79,1377000,5,-222000,Clayton County,Clayton County-Mecklenburg County-NC
3479,Clayton County-Hillsborough County-FL-1920,"Hillsborough County, FL",1920,2019,2020,77,1149000,81,1300000,-4,-151000,Clayton County,Clayton County-Hillsborough County-FL
3480,Clayton County-Palm Beach County-FL-1920,"Palm Beach County, FL",1920,2019,2020,63,1396000,46,271000,17,1125000,Clayton County,Clayton County-Palm Beach County-FL
3481,Clayton County-Carroll County-GA-1920,"Carroll County, GA",1920,2019,2020,74,786000,65,887000,9,-101000,Clayton County,Clayton County-Carroll County-GA
3482,Clayton County-Marion County-IN-1920,"Marion County, IN",1920,2019,2020,66,693000,42,444000,24,249000,Clayton County,Clayton County-Marion County-IN
3483,Clayton County-Philadelphia County-PA-1920,"Philadelphia County, PA",1920,2019,2020,75,868000,49,446000,26,422000,Clayton County,Clayton County-Philadelphia County-PA
3484,Clayton County-Butts County-GA-1920,"Butts County, GA",1920,2019,2020,75,946000,121,2001000,-46,-1055000,Clayton County,Clayton County-Butts County-GA
3485,Clayton County-Shelby County-TN-1920,"Shelby County, TN",1920,2019,2020,60,714000,55,499000,5,215000,Clayton County,Clayton County-Shelby County-TN
3486,Clayton County-Houston County-GA-1920,"Houston County, GA",1920,2019,2020,53,682000,112,1772000,-59,-1090000,Clayton County,Clayton County-Houston County-GA
3487,Clayton County-Cumberland County-NC-1920,"Cumberland County, NC",1920,2019,2020,67,863000,36,386000,31,477000,Clayton County,Clayton County-Cumberland County-NC
3488,Clayton County-Montgomery County-AL-1920,"Montgomery County, AL",1920,2019,2020,54,861000,48,713000,6,148000,Clayton County,Clayton County-Montgomery County-AL
3489,Clayton County-Clark County-NV-1920,"Clark County, NV",1920,2019,2020,53,808000,79,992000,-26,-184000,Clayton County,Clayton County-Clark County-NV
3490,Clayton County-Cherokee County-GA-1920,"Cherokee County, GA",1920,2019,2020,45,920000,117,1877000,-72,-957000,Clayton County,Clayton County-Cherokee County-GA
3491,Clayton County-Davidson County-TN-1920,"Davidson County, TN",1920,2019,2020,45,814000,42,785000,3,29000,Clayton County,Clayton County-Davidson County-TN
3492,Clayton County-Jefferson County-AL-1920,"Jefferson County, AL",1920,2019,2020,49,758000,69,812000,-20,-54000,Clayton County,Clayton County-Jefferson County-AL
3493,Clayton County-Maricopa County-AZ-1920,"Maricopa County, AZ",1920,2019,2020,54,1103000,55,886000,-1,217000,Clayton County,Clayton County-Maricopa County-AZ
3494,Clayton County-Richland County-SC-1920,"Richland County, SC",1920,2019,2020,38,908000,50,548000,-12,360000,Clayton County,Clayton County-Richland County-SC
3495,Clayton County-Bartow County-GA-1920,"Bartow County, GA",1920,2019,2020,50,675000,44,504000,6,171000,Clayton County,Clayton County-Bartow County-GA
3496,Clayton County-Troup County-GA-1920,"Troup County, GA",1920,2019,2020,53,598000,74,903000,-21,-305000,Clayton County,Clayton County-Troup County-GA
3497,Clayton County-Dallas County-TX-1920,"Dallas County, TX",1920,2019,2020,43,790000,73,1029000,-30,-239000,Clayton County,Clayton County-Dallas County-TX
3499,Cobb County-Fulton County-GA-1920,"Fulton County, GA",1920,2019,2020,9931,499533000,8639,458587000,1292,40946000,Cobb County,Cobb County-Fulton County-GA
3500,Cobb County-DeKalb County-GA-1920,"DeKalb County, GA",1920,2019,2020,3698,141898000,2710,99739000,988,42159000,Cobb County,Cobb County-DeKalb County-GA
3501,Cobb County-Cherokee County-GA-1920,"Cherokee County, GA",1920,2019,2020,2874,88012000,5364,211013000,-2490,-123001000,Cobb County,Cobb County-Cherokee County-GA
3502,Cobb County-Paulding County-GA-1920,"Paulding County, GA",1920,2019,2020,3013,86571000,5685,145094000,-2672,-58523000,Cobb County,Cobb County-Paulding County-GA
3503,Cobb County-Gwinnett County-GA-1920,"Gwinnett County, GA",1920,2019,2020,2090,64320000,2192,60089000,-102,4231000,Cobb County,Cobb County-Gwinnett County-GA
3504,Cobb County-Douglas County-GA-1920,"Douglas County, GA",1920,2019,2020,1935,41779000,2980,55016000,-1045,-13237000,Cobb County,Cobb County-Douglas County-GA
3505,Cobb County-Clayton County-GA-1920,"Clayton County, GA",1920,2019,2020,934,13082000,948,14329000,-14,-1247000,Cobb County,Cobb County-Clayton County-GA
3506,Cobb County-Bartow County-GA-1920,"Bartow County, GA",1920,2019,2020,788,16822000,1489,47988000,-701,-31166000,Cobb County,Cobb County-Bartow County-GA
3507,Cobb County-Henry County-GA-1920,"Henry County, GA",1920,2019,2020,500,16996000,537,14564000,-37,2432000,Cobb County,Cobb County-Henry County-GA
3508,Cobb County-Forsyth County-GA-1920,"Forsyth County, GA",1920,2019,2020,446,21167000,1099,46800000,-653,-25633000,Cobb County,Cobb County-Forsyth County-GA
3509,Cobb County-Los Angeles County-CA-1920,"Los Angeles County, CA",1920,2019,2020,413,16164000,251,10490000,162,5674000,Cobb County,Cobb County-Los Angeles County-CA
3510,Cobb County-Broward County-FL-1920,"Broward County, FL",1920,2019,2020,412,9929000,269,11618000,143,-1689000,Cobb County,Cobb County-Broward County-FL
3511,Cobb County-Cook County-IL-1920,"Cook County, IL",1920,2019,2020,374,18393000,184,5936000,190,12457000,Cobb County,Cobb County-Cook County-IL
3512,Cobb County-Miami-Dade County-FL-1920,"Miami-Dade County, FL",1920,2019,2020,374,9817000,199,11518000,175,-1701000,Cobb County,Cobb County-Miami-Dade County-FL
3513,Cobb County-Carroll County-GA-1920,"Carroll County, GA",1920,2019,2020,286,8120000,427,10573000,-141,-2453000,Cobb County,Cobb County-Carroll County-GA
3514,Cobb County-Orange County-FL-1920,"Orange County, FL",1920,2019,2020,343,9832000,242,10538000,101,-706000,Cobb County,Cobb County-Orange County-FL
3515,Cobb County-Kings County-NY-1920,"Kings County, NY",1920,2019,2020,314,11950000,94,3325000,220,8625000,Cobb County,Cobb County-Kings County-NY
3516,Cobb County-Coweta County-GA-1920,"Coweta County, GA",1920,2019,2020,235,9753000,318,17224000,-83,-7471000,Cobb County,Cobb County-Coweta County-GA
3517,Cobb County-Harris County-TX-1920,"Harris County, TX",1920,2019,2020,289,12271000,292,12172000,-3,99000,Cobb County,Cobb County-Harris County-TX
3518,Cobb County-Fayette County-GA-1920,"Fayette County, GA",1920,2019,2020,238,9771000,324,14546000,-86,-4775000,Cobb County,Cobb County-Fayette County-GA
3519,Cobb County-Chatham County-GA-1920,"Chatham County, GA",1920,2019,2020,206,9868000,144,4533000,62,5335000,Cobb County,Cobb County-Chatham County-GA
3520,Cobb County-Mecklenburg County-NC-1920,"Mecklenburg County, NC",1920,2019,2020,204,8997000,272,15840000,-68,-6843000,Cobb County,Cobb County-Mecklenburg County-NC
3521,Cobb County-Palm Beach County-FL-1920,"Palm Beach County, FL",1920,2019,2020,248,8860000,229,12693000,19,-3833000,Cobb County,Cobb County-Palm Beach County-FL
3522,Cobb County-Duval County-FL-1920,"Duval County, FL",1920,2019,2020,218,7889000,245,10417000,-27,-2528000,Cobb County,Cobb County-Duval County-FL
3523,Cobb County-New York County-NY-1920,"New York County, NY",1920,2019,2020,191,14816000,89,3859000,102,10957000,Cobb County,Cobb County-New York County-NY
3524,Cobb County-Hillsborough County-FL-1920,"Hillsborough County, FL",1920,2019,2020,241,7988000,265,10016000,-24,-2028000,Cobb County,Cobb County-Hillsborough County-FL
3525,Cobb County-Queens County-NY-1920,"Queens County, NY",1920,2019,2020,219,7136000,53,1148000,166,5988000,Cobb County,Cobb County-Queens County-NY
3526,Cobb County-Jefferson County-AL-1920,"Jefferson County, AL",1920,2019,2020,210,9822000,139,6325000,71,3497000,Cobb County,Cobb County-Jefferson County-AL
3527,Cobb County-Bibb County-GA-1920,"Bibb County, GA",1920,2019,2020,192,6042000,135,3244000,57,2798000,Cobb County,Cobb County-Bibb County-GA
3528,Cobb County-Maricopa County-AZ-1920,"Maricopa County, AZ",1920,2019,2020,190,7996000,174,8165000,16,-169000,Cobb County,Cobb County-Maricopa County-AZ
3529,Cobb County-Muscogee County-GA-1920,"Muscogee County, GA",1920,2019,2020,180,5256000,124,3299000,56,1957000,Cobb County,Cobb County-Muscogee County-GA
3530,Cobb County-Clarke County-GA-1920,"Clarke County, GA",1920,2019,2020,127,3184000,119,3386000,8,-202000,Cobb County,Cobb County-Clarke County-GA
3531,Cobb County-Floyd County-GA-1920,"Floyd County, GA",1920,2019,2020,163,5602000,209,6547000,-46,-945000,Cobb County,Cobb County-Floyd County-GA
3532,Cobb County-Hall County-GA-1920,"Hall County, GA",1920,2019,2020,148,4709000,217,14505000,-69,-9796000,Cobb County,Cobb County-Hall County-GA
3533,Cobb County-Rockdale County-GA-1920,"Rockdale County, GA",1920,2019,2020,171,3169000,199,4544000,-28,-1375000,Cobb County,Cobb County-Rockdale County-GA
3534,Cobb County-Dallas County-TX-1920,"Dallas County, TX",1920,2019,2020,179,8062000,214,6824000,-35,1238000,Cobb County,Cobb County-Dallas County-TX
3535,Cobb County-Shelby County-TN-1920,"Shelby County, TN",1920,2019,2020,151,5899000,115,4226000,36,1673000,Cobb County,Cobb County-Shelby County-TN
3536,Cobb County-Wake County-NC-1920,"Wake County, NC",1920,2019,2020,147,6896000,172,8133000,-25,-1237000,Cobb County,Cobb County-Wake County-NC
3537,Cobb County-Newton County-GA-1920,"Newton County, GA",1920,2019,2020,141,3286000,143,4722000,-2,-1436000,Cobb County,Cobb County-Newton County-GA
3538,Cobb County-Davidson County-TN-1920,"Davidson County, TN",1920,2019,2020,124,7999000,144,6814000,-20,1185000,Cobb County,Cobb County-Davidson County-TN
3539,Cobb County-Orange County-CA-1920,"Orange County, CA",1920,2019,2020,147,7766000,98,7573000,49,193000,Cobb County,Cobb County-Orange County-CA
3540,Cobb County-Hamilton County-TN-1920,"Hamilton County, TN",1920,2019,2020,157,5649000,158,7960000,-1,-2311000,Cobb County,Cobb County-Hamilton County-TN
3541,Cobb County-Pinellas County-FL-1920,"Pinellas County, FL",1920,2019,2020,122,6967000,130,4843000,-8,2124000,Cobb County,Cobb County-Pinellas County-FL
3542,Cobb County-Tarrant County-TX-1920,"Tarrant County, TX",1920,2019,2020,150,5833000,141,5373000,9,460000,Cobb County,Cobb County-Tarrant County-TX
3543,Cobb County-Fairfax County-VA-1920,"Fairfax County, VA",1920,2019,2020,146,8308000,102,3581000,44,4727000,Cobb County,Cobb County-Fairfax County-VA
3544,Cobb County-Houston County-GA-1920,"Houston County, GA",1920,2019,2020,119,3549000,128,3589000,-9,-40000,Cobb County,Cobb County-Houston County-GA
3545,Cobb County-Richmond County-GA-1920,"Richmond County, GA",1920,2019,2020,112,2975000,122,2695000,-10,280000,Cobb County,Cobb County-Richmond County-GA
3546,Cobb County-San Diego County-CA-1920,"San Diego County, CA",1920,2019,2020,138,4503000,150,4731000,-12,-228000,Cobb County,Cobb County-San Diego County-CA
3547,Cobb County-Philadelphia County-PA-1920,"Philadelphia County, PA",1920,2019,2020,112,3933000,52,1007000,60,2926000,Cobb County,Cobb County-Philadelphia County-PA
3548,Cobb County-Clark County-NV-1920,"Clark County, NV",1920,2019,2020,128,2868000,151,4420000,-23,-1552000,Cobb County,Cobb County-Clark County-NV
3549,Cobb County-Franklin County-OH-1920,"Franklin County, OH",1920,2019,2020,132,5100000,83,2799000,49,2301000,Cobb County,Cobb County-Franklin County-OH
3550,Cobb County-Wayne County-MI-1920,"Wayne County, MI",1920,2019,2020,120,3258000,83,2323000,37,935000,Cobb County,Cobb County-Wayne County-MI
3551,Cobb County-King County-WA-1920,"King County, WA",1920,2019,2020,99,7979000,163,8670000,-64,-691000,Cobb County,Cobb County-King County-WA
3552,Cobb County-Bronx County-NY-1920,"Bronx County, NY",1920,2019,2020,121,2709000,44,513000,77,2196000,Cobb County,Cobb County-Bronx County-NY
3553,Cobb County-District of Columbia-DC-1920,"District of Columbia, DC",1920,2019,2020,84,4052000,50,1806000,34,2246000,Cobb County,Cobb County-District of Columbia-DC
3554,Cobb County-St. Louis County-MO-1920,"St. Louis County, MO",1920,2019,2020,119,3509000,68,3124000,51,385000,Cobb County,Cobb County-St. Louis County-MO
3555,Cobb County-Brevard County-FL-1920,"Brevard County, FL",1920,2019,2020,87,3179000,101,4417000,-14,-1238000,Cobb County,Cobb County-Brevard County-FL
3556,Cobb County-Columbia County-GA-1920,"Columbia County, GA",1920,2019,2020,95,3569000,110,3102000,-15,467000,Cobb County,Cobb County-Columbia County-GA
3557,Cobb County-Montgomery County-AL-1920,"Montgomery County, AL",1920,2019,2020,100,2486000,62,1845000,38,641000,Cobb County,Cobb County-Montgomery County-AL
3558,Cobb County-Lee County-FL-1920,"Lee County, FL",1920,2019,2020,105,4133000,70,5669000,35,-1536000,Cobb County,Cobb County-Lee County-FL
3559,Cobb County-Oakland County-MI-1920,"Oakland County, MI",1920,2019,2020,107,6475000,100,3783000,7,2692000,Cobb County,Cobb County-Oakland County-MI
3560,Cobb County-Charleston County-SC-1920,"Charleston County, SC",1920,2019,2020,91,3720000,137,7734000,-46,-4014000,Cobb County,Cobb County-Charleston County-SC
3561,Cobb County-Richland County-SC-1920,"Richland County, SC",1920,2019,2020,98,2939000,76,3522000,22,-583000,Cobb County,Cobb County-Richland County-SC
3562,Cobb County-Prince George's County-MD-1920,"Prince George's County, MD",1920,2019,2020,86,2467000,79,1709000,7,758000,Cobb County,Cobb County-Prince George's County-MD
3563,Cobb County-Essex County-NJ-1920,"Essex County, NJ",1920,2019,2020,101,2605000,32,1593000,69,1012000,Cobb County,Cobb County-Essex County-NJ
3564,Cobb County-Nassau County-NY-1920,"Nassau County, NY",1920,2019,2020,98,4817000,42,1536000,56,3281000,Cobb County,Cobb County-Nassau County-NY
3565,Cobb County-Travis County-TX-1920,"Travis County, TX",1920,2019,2020,95,3894000,105,4346000,-10,-452000,Cobb County,Cobb County-Travis County-TX
3566,Cobb County-Leon County-FL-1920,"Leon County, FL",1920,2019,2020,83,2626000,50,1612000,33,1014000,Cobb County,Cobb County-Leon County-FL
3567,Cobb County-Polk County-GA-1920,"Polk County, GA",1920,2019,2020,85,2300000,162,3632000,-77,-1332000,Cobb County,Cobb County-Polk County-GA
3568,Cobb County-Lowndes County-GA-1920,"Lowndes County, GA",1920,2019,2020,76,1905000,38,1037000,38,868000,Cobb County,Cobb County-Lowndes County-GA
3569,Cobb County-Walton County-GA-1920,"Walton County, GA",1920,2019,2020,87,2241000,153,3982000,-66,-1741000,Cobb County,Cobb County-Walton County-GA
3570,Cobb County-Dougherty County-GA-1920,"Dougherty County, GA",1920,2019,2020,94,2842000,36,783000,58,2059000,Cobb County,Cobb County-Dougherty County-GA
3571,Cobb County-Volusia County-FL-1920,"Volusia County, FL",1920,2019,2020,83,1983000,81,3079000,2,-1096000,Cobb County,Cobb County-Volusia County-FL
3572,Cobb County-Alameda County-CA-1920,"Alameda County, CA",1920,2019,2020,94,6597000,59,3700000,35,2897000,Cobb County,Cobb County-Alameda County-CA
3573,Cobb County-Middlesex County-MA-1920,"Middlesex County, MA",1920,2019,2020,76,3991000,74,5163000,2,-1172000,Cobb County,Cobb County-Middlesex County-MA
3574,Cobb County-Riverside County-CA-1920,"Riverside County, CA",1920,2019,2020,90,2663000,52,2015000,38,648000,Cobb County,Cobb County-Riverside County-CA
3575,Cobb County-Allegheny County-PA-1920,"Allegheny County, PA",1920,2019,2020,87,2927000,55,2442000,32,485000,Cobb County,Cobb County-Allegheny County-PA
3576,Cobb County-Mobile County-AL-1920,"Mobile County, AL",1920,2019,2020,96,1837000,79,1789000,17,48000,Cobb County,Cobb County-Mobile County-AL
3577,Cobb County-Cuyahoga County-OH-1920,"Cuyahoga County, OH",1920,2019,2020,87,2069000,84,2330000,3,-261000,Cobb County,Cobb County-Cuyahoga County-OH
3578,Cobb County-Knox County-TN-1920,"Knox County, TN",1920,2019,2020,78,2797000,84,3788000,-6,-991000,Cobb County,Cobb County-Knox County-TN
3579,Cobb County-Pickens County-GA-1920,"Pickens County, GA",1920,2019,2020,62,2204000,195,10573000,-133,-8369000,Cobb County,Cobb County-Pickens County-GA
3580,Cobb County-Greenville County-SC-1920,"Greenville County, SC",1920,2019,2020,93,2081000,106,5622000,-13,-3541000,Cobb County,Cobb County-Greenville County-SC
3581,Cobb County-Bexar County-TX-1920,"Bexar County, TX",1920,2019,2020,86,2787000,93,9208000,-7,-6421000,Cobb County,Cobb County-Bexar County-TX
3582,Cobb County-Lee County-AL-1920,"Lee County, AL",1920,2019,2020,56,1596000,72,8778000,-16,-7182000,Cobb County,Cobb County-Lee County-AL
3583,Cobb County-Santa Clara County-CA-1920,"Santa Clara County, CA",1920,2019,2020,75,5989000,86,4698000,-11,1291000,Cobb County,Cobb County-Santa Clara County-CA
3584,Cobb County-Escambia County-FL-1920,"Escambia County, FL",1920,2019,2020,83,1539000,92,3437000,-9,-1898000,Cobb County,Cobb County-Escambia County-FL
3585,Cobb County-Whitfield County-GA-1920,"Whitfield County, GA",1920,2019,2020,69,1196000,70,1881000,-1,-685000,Cobb County,Cobb County-Whitfield County-GA
3586,Cobb County-Hudson County-NJ-1920,"Hudson County, NJ",1920,2019,2020,73,4072000,53,3068000,20,1004000,Cobb County,Cobb County-Hudson County-NJ
3587,Cobb County-Hamilton County-OH-1920,"Hamilton County, OH",1920,2019,2020,80,2001000,55,2185000,25,-184000,Cobb County,Cobb County-Hamilton County-OH
3588,Cobb County-Collin County-TX-1920,"Collin County, TX",1920,2019,2020,85,4995000,129,6141000,-44,-1146000,Cobb County,Cobb County-Collin County-TX
3589,Cobb County-Montgomery County-MD-1920,"Montgomery County, MD",1920,2019,2020,77,3591000,77,2657000,0,934000,Cobb County,Cobb County-Montgomery County-MD
3590,Cobb County-Fort Bend County-TX-1920,"Fort Bend County, TX",1920,2019,2020,105,3869000,51,1464000,54,2405000,Cobb County,Cobb County-Fort Bend County-TX
3591,Cobb County-Seminole County-FL-1920,"Seminole County, FL",1920,2019,2020,62,2587000,105,4003000,-43,-1416000,Cobb County,Cobb County-Seminole County-FL
3592,Cobb County-Marion County-IN-1920,"Marion County, IN",1920,2019,2020,67,1629000,41,1377000,26,252000,Cobb County,Cobb County-Marion County-IN
3593,Cobb County-Guilford County-NC-1920,"Guilford County, NC",1920,2019,2020,52,1793000,68,2967000,-16,-1174000,Cobb County,Cobb County-Guilford County-NC
3594,Cobb County-Barrow County-GA-1920,"Barrow County, GA",1920,2019,2020,50,1255000,66,1869000,-16,-614000,Cobb County,Cobb County-Barrow County-GA
3595,Cobb County-Virginia Beach city-VA-1920,"Virginia Beach city, VA",1920,2019,2020,71,3399000,42,1576000,29,1823000,Cobb County,Cobb County-Virginia Beach city-VA
3596,Cobb County-Madison County-AL-1920,"Madison County, AL",1920,2019,2020,64,2444000,97,3209000,-33,-765000,Cobb County,Cobb County-Madison County-AL
3597,Cobb County-Suffolk County-MA-1920,"Suffolk County, MA",1920,2019,2020,49,3153000,34,1456000,15,1697000,Cobb County,Cobb County-Suffolk County-MA
3598,Cobb County-Bay County-FL-1920,"Bay County, FL",1920,2019,2020,58,1508000,57,2845000,1,-1337000,Cobb County,Cobb County-Bay County-FL
3599,Cobb County-Glynn County-GA-1920,"Glynn County, GA",1920,2019,2020,60,1912000,61,4921000,-1,-3009000,Cobb County,Cobb County-Glynn County-GA
3600,Cobb County-Hennepin County-MN-1920,"Hennepin County, MN",1920,2019,2020,67,3388000,52,5192000,15,-1804000,Cobb County,Cobb County-Hennepin County-MN
3601,Cobb County-Arapahoe County-CO-1920,"Arapahoe County, CO",1920,2019,2020,60,1856000,54,1849000,6,7000,Cobb County,Cobb County-Arapahoe County-CO
3602,Cobb County-Polk County-FL-1920,"Polk County, FL",1920,2019,2020,58,1957000,59,1710000,-1,247000,Cobb County,Cobb County-Polk County-FL
3603,Cobb County-Bulloch County-GA-1920,"Bulloch County, GA",1920,2019,2020,58,1502000,37,1086000,21,416000,Cobb County,Cobb County-Bulloch County-GA
3604,Cobb County-Baltimore County-MD-1920,"Baltimore County, MD",1920,2019,2020,56,1962000,36,1184000,20,778000,Cobb County,Cobb County-Baltimore County-MD
3605,Cobb County-Durham County-NC-1920,"Durham County, NC",1920,2019,2020,49,1569000,39,1968000,10,-399000,Cobb County,Cobb County-Durham County-NC
3606,Cobb County-Rutherford County-TN-1920,"Rutherford County, TN",1920,2019,2020,54,1512000,74,1923000,-20,-411000,Cobb County,Cobb County-Rutherford County-TN
3607,Cobb County-Salt Lake County-UT-1920,"Salt Lake County, UT",1920,2019,2020,62,2544000,57,2615000,5,-71000,Cobb County,Cobb County-Salt Lake County-UT
3608,Cobb County-San Bernardino County-CA-1920,"San Bernardino County, CA",1920,2019,2020,67,1689000,44,878000,23,811000,Cobb County,Cobb County-San Bernardino County-CA
3609,Cobb County-Manatee County-FL-1920,"Manatee County, FL",1920,2019,2020,59,2761000,80,6708000,-21,-3947000,Cobb County,Cobb County-Manatee County-FL
3610,Cobb County-Osceola County-FL-1920,"Osceola County, FL",1920,2019,2020,76,1509000,49,1455000,27,54000,Cobb County,Cobb County-Osceola County-FL
3611,Cobb County-Gordon County-GA-1920,"Gordon County, GA",1920,2019,2020,46,2008000,146,4587000,-100,-2579000,Cobb County,Cobb County-Gordon County-GA
3612,Cobb County-Jackson County-GA-1920,"Jackson County, GA",1920,2019,2020,51,1217000,51,1957000,0,-740000,Cobb County,Cobb County-Jackson County-GA
3613,Cobb County-Denver County-CO-1920,"Denver County, CO",1920,2019,2020,49,1605000,66,2386000,-17,-781000,Cobb County,Cobb County-Denver County-CO
3614,Cobb County-Alachua County-FL-1920,"Alachua County, FL",1920,2019,2020,40,1115000,34,1451000,6,-336000,Cobb County,Cobb County-Alachua County-FL
3615,Cobb County-Buncombe County-NC-1920,"Buncombe County, NC",1920,2019,2020,39,1763000,68,3605000,-29,-1842000,Cobb County,Cobb County-Buncombe County-NC
3616,Cobb County-Denton County-TX-1920,"Denton County, TX",1920,2019,2020,71,2778000,84,3971000,-13,-1193000,Cobb County,Cobb County-Denton County-TX
3617,Cobb County-Loudoun County-VA-1920,"Loudoun County, VA",1920,2019,2020,66,4854000,46,2314000,20,2540000,Cobb County,Cobb County-Loudoun County-VA
3618,Cobb County-Pierce County-WA-1920,"Pierce County, WA",1920,2019,2020,77,1757000,41,1020000,36,737000,Cobb County,Cobb County-Pierce County-WA
3619,Cobb County-Orleans Parish-LA-1920,"Orleans Parish, LA",1920,2019,2020,48,1654000,47,1140000,1,514000,Cobb County,Cobb County-Orleans Parish-LA
3620,Cobb County-Baldwin County-AL-1920,"Baldwin County, AL",1920,2019,2020,48,2274000,70,4102000,-22,-1828000,Cobb County,Cobb County-Baldwin County-AL
3621,Cobb County-Shelby County-AL-1920,"Shelby County, AL",1920,2019,2020,53,1915000,75,4369000,-22,-2454000,Cobb County,Cobb County-Shelby County-AL
3622,Cobb County-Monroe County-NY-1920,"Monroe County, NY",1920,2019,2020,49,1196000,32,808000,17,388000,Cobb County,Cobb County-Monroe County-NY
3623,Cobb County-Lake County-FL-1920,"Lake County, FL",1920,2019,2020,48,1234000,47,2049000,1,-815000,Cobb County,Cobb County-Lake County-FL
3624,Cobb County-Jefferson County-KY-1920,"Jefferson County, KY",1920,2019,2020,47,2343000,46,1688000,1,655000,Cobb County,Cobb County-Jefferson County-KY
3625,Cobb County-Beaufort County-SC-1920,"Beaufort County, SC",1920,2019,2020,44,2508000,125,10924000,-81,-8416000,Cobb County,Cobb County-Beaufort County-SC
3626,Cobb County-Haralson County-GA-1920,"Haralson County, GA",1920,2019,2020,38,750000,81,2074000,-43,-1324000,Cobb County,Cobb County-Haralson County-GA
3627,Cobb County-East Baton Rouge Parish-LA-1920,"East Baton Rouge Parish, LA",1920,2019,2020,47,1157000,44,965000,3,192000,Cobb County,Cobb County-East Baton Rouge Parish-LA
3628,Cobb County-Tuscaloosa County-AL-1920,"Tuscaloosa County, AL",1920,2019,2020,45,2538000,28,762000,17,1776000,Cobb County,Cobb County-Tuscaloosa County-AL
3629,Cobb County-Troup County-GA-1920,"Troup County, GA",1920,2019,2020,35,1055000,51,2154000,-16,-1099000,Cobb County,Cobb County-Troup County-GA
3630,Cobb County-Cumberland County-NC-1920,"Cumberland County, NC",1920,2019,2020,38,1248000,58,693000,-20,555000,Cobb County,Cobb County-Cumberland County-NC
3631,Cobb County-Sacramento County-CA-1920,"Sacramento County, CA",1920,2019,2020,41,1447000,35,1122000,6,325000,Cobb County,Cobb County-Sacramento County-CA
3632,Cobb County-El Paso County-CO-1920,"El Paso County, CO",1920,2019,2020,43,1215000,64,1987000,-21,-772000,Cobb County,Cobb County-El Paso County-CO
3633,Cobb County-Oconee County-GA-1920,"Oconee County, GA",1920,2019,2020,46,2167000,44,1574000,2,593000,Cobb County,Cobb County-Oconee County-GA
3634,Cobb County-Spalding County-GA-1920,"Spalding County, GA",1920,2019,2020,46,946000,58,2371000,-12,-1425000,Cobb County,Cobb County-Spalding County-GA
3635,Cobb County-Jefferson Parish-LA-1920,"Jefferson Parish, LA",1920,2019,2020,40,819000,41,921000,-1,-102000,Cobb County,Cobb County-Jefferson Parish-LA
3636,Cobb County-Williamson County-TN-1920,"Williamson County, TN",1920,2019,2020,66,3258000,80,4831000,-14,-1573000,Cobb County,Cobb County-Williamson County-TN
3637,Cobb County-Calhoun County-AL-1920,"Calhoun County, AL",1920,2019,2020,46,1128000,37,1264000,9,-136000,Cobb County,Cobb County-Calhoun County-AL
3638,Cobb County-Gilmer County-GA-1920,"Gilmer County, GA",1920,2019,2020,40,1772000,109,6111000,-69,-4339000,Cobb County,Cobb County-Gilmer County-GA
3639,Cobb County-St. Johns County-FL-1920,"St. Johns County, FL",1920,2019,2020,45,1765000,103,8907000,-58,-7142000,Cobb County,Cobb County-St. Johns County-FL
3640,Cobb County-Sarasota County-FL-1920,"Sarasota County, FL",1920,2019,2020,38,2069000,69,5712000,-31,-3643000,Cobb County,Cobb County-Sarasota County-FL
3641,Cobb County-Collier County-FL-1920,"Collier County, FL",1920,2019,2020,46,913000,60,4519000,-14,-3606000,Cobb County,Cobb County-Collier County-FL
3642,Cobb County-Lumpkin County-GA-1920,"Lumpkin County, GA",1920,2019,2020,27,885000,45,4817000,-18,-3932000,Cobb County,Cobb County-Lumpkin County-GA
3643,Cobb County-Forsyth County-NC-1920,"Forsyth County, NC",1920,2019,2020,31,959000,48,1677000,-17,-718000,Cobb County,Cobb County-Forsyth County-NC
3644,Cobb County-York County-SC-1920,"York County, SC",1920,2019,2020,44,1893000,56,2169000,-12,-276000,Cobb County,Cobb County-York County-SC
3645,Cobb County-Johnson County-KS-1920,"Johnson County, KS",1920,2019,2020,33,1456000,44,2269000,-11,-813000,Cobb County,Cobb County-Johnson County-KS
3647,DeKalb County-Fulton County-GA-1920,"Fulton County, GA",1920,2019,2020,14585,732016000,14267,672510000,318,59506000,DeKalb County,DeKalb County-Fulton County-GA
3648,DeKalb County-Gwinnett County-GA-1920,"Gwinnett County, GA",1920,2019,2020,7944,205329000,12247,273895000,-4303,-68566000,DeKalb County,DeKalb County-Gwinnett County-GA
3649,DeKalb County-Cobb County-GA-1920,"Cobb County, GA",1920,2019,2020,2710,99739000,3698,141898000,-988,-42159000,DeKalb County,DeKalb County-Cobb County-GA
3650,DeKalb County-Clayton County-GA-1920,"Clayton County, GA",1920,2019,2020,2877,38594000,3566,46808000,-689,-8214000,DeKalb County,DeKalb County-Clayton County-GA
3651,DeKalb County-Rockdale County-GA-1920,"Rockdale County, GA",1920,2019,2020,1312,23510000,2151,42441000,-839,-18931000,DeKalb County,DeKalb County-Rockdale County-GA
3652,DeKalb County-Henry County-GA-1920,"Henry County, GA",1920,2019,2020,1024,21667000,2133,44536000,-1109,-22869000,DeKalb County,DeKalb County-Henry County-GA
3653,DeKalb County-Newton County-GA-1920,"Newton County, GA",1920,2019,2020,812,14479000,1460,25538000,-648,-11059000,DeKalb County,DeKalb County-Newton County-GA
3654,DeKalb County-Los Angeles County-CA-1920,"Los Angeles County, CA",1920,2019,2020,453,19637000,311,15746000,142,3891000,DeKalb County,DeKalb County-Los Angeles County-CA
3655,DeKalb County-Cook County-IL-1920,"Cook County, IL",1920,2019,2020,413,21616000,277,12080000,136,9536000,DeKalb County,DeKalb County-Cook County-IL
3656,DeKalb County-Forsyth County-GA-1920,"Forsyth County, GA",1920,2019,2020,385,20063000,1074,44701000,-689,-24638000,DeKalb County,DeKalb County-Forsyth County-GA
3657,DeKalb County-Douglas County-GA-1920,"Douglas County, GA",1920,2019,2020,437,9311000,551,10184000,-114,-873000,DeKalb County,DeKalb County-Douglas County-GA
3658,DeKalb County-Kings County-NY-1920,"Kings County, NY",1920,2019,2020,379,14993000,184,5187000,195,9806000,DeKalb County,DeKalb County-Kings County-NY
3659,DeKalb County-Broward County-FL-1920,"Broward County, FL",1920,2019,2020,386,8562000,254,8959000,132,-397000,DeKalb County,DeKalb County-Broward County-FL
3660,DeKalb County-Miami-Dade County-FL-1920,"Miami-Dade County, FL",1920,2019,2020,345,10584000,225,6239000,120,4345000,DeKalb County,DeKalb County-Miami-Dade County-FL
3661,DeKalb County-Mecklenburg County-NC-1920,"Mecklenburg County, NC",1920,2019,2020,280,11285000,294,13499000,-14,-2214000,DeKalb County,DeKalb County-Mecklenburg County-NC
3662,DeKalb County-Cherokee County-GA-1920,"Cherokee County, GA",1920,2019,2020,247,9480000,447,20099000,-200,-10619000,DeKalb County,DeKalb County-Cherokee County-GA
3663,DeKalb County-Orange County-FL-1920,"Orange County, FL",1920,2019,2020,269,7188000,200,9416000,69,-2228000,DeKalb County,DeKalb County-Orange County-FL
3664,DeKalb County-New York County-NY-1920,"New York County, NY",1920,2019,2020,230,28736000,159,9501000,71,19235000,DeKalb County,DeKalb County-New York County-NY
3665,DeKalb County-Clarke County-GA-1920,"Clarke County, GA",1920,2019,2020,188,5660000,257,9959000,-69,-4299000,DeKalb County,DeKalb County-Clarke County-GA
3666,DeKalb County-Chatham County-GA-1920,"Chatham County, GA",1920,2019,2020,237,7709000,246,9888000,-9,-2179000,DeKalb County,DeKalb County-Chatham County-GA
3667,DeKalb County-Queens County-NY-1920,"Queens County, NY",1920,2019,2020,261,11239000,92,2869000,169,8370000,DeKalb County,DeKalb County-Queens County-NY
3668,DeKalb County-Duval County-FL-1920,"Duval County, FL",1920,2019,2020,265,6128000,267,9712000,-2,-3584000,DeKalb County,DeKalb County-Duval County-FL
3669,DeKalb County-Hillsborough County-FL-1920,"Hillsborough County, FL",1920,2019,2020,253,9585000,210,10948000,43,-1363000,DeKalb County,DeKalb County-Hillsborough County-FL
3670,DeKalb County-Harris County-TX-1920,"Harris County, TX",1920,2019,2020,239,14558000,350,10496000,-111,4062000,DeKalb County,DeKalb County-Harris County-TX
3671,DeKalb County-Fayette County-GA-1920,"Fayette County, GA",1920,2019,2020,181,11712000,319,11662000,-138,50000,DeKalb County,DeKalb County-Fayette County-GA
3672,DeKalb County-Davidson County-TN-1920,"Davidson County, TN",1920,2019,2020,192,6455000,169,8751000,23,-2296000,DeKalb County,DeKalb County-Davidson County-TN
3673,DeKalb County-Hall County-GA-1920,"Hall County, GA",1920,2019,2020,197,7369000,292,13198000,-95,-5829000,DeKalb County,DeKalb County-Hall County-GA
3674,DeKalb County-Walton County-GA-1920,"Walton County, GA",1920,2019,2020,200,4970000,398,8745000,-198,-3775000,DeKalb County,DeKalb County-Walton County-GA
3675,DeKalb County-Palm Beach County-FL-1920,"Palm Beach County, FL",1920,2019,2020,183,5885000,170,9822000,13,-3937000,DeKalb County,DeKalb County-Palm Beach County-FL
3676,DeKalb County-Bibb County-GA-1920,"Bibb County, GA",1920,2019,2020,174,4894000,217,3331000,-43,1563000,DeKalb County,DeKalb County-Bibb County-GA
3677,DeKalb County-Richmond County-GA-1920,"Richmond County, GA",1920,2019,2020,192,4016000,173,3581000,19,435000,DeKalb County,DeKalb County-Richmond County-GA
3678,DeKalb County-Muscogee County-GA-1920,"Muscogee County, GA",1920,2019,2020,181,4142000,184,4277000,-3,-135000,DeKalb County,DeKalb County-Muscogee County-GA
3679,DeKalb County-Dallas County-TX-1920,"Dallas County, TX",1920,2019,2020,158,7960000,250,11852000,-92,-3892000,DeKalb County,DeKalb County-Dallas County-TX
3680,DeKalb County-Coweta County-GA-1920,"Coweta County, GA",1920,2019,2020,153,5399000,166,7409000,-13,-2010000,DeKalb County,DeKalb County-Coweta County-GA
3681,DeKalb County-District of Columbia-DC-1920,"District of Columbia, DC",1920,2019,2020,139,9320000,117,6857000,22,2463000,DeKalb County,DeKalb County-District of Columbia-DC
3682,DeKalb County-Jefferson County-AL-1920,"Jefferson County, AL",1920,2019,2020,165,5736000,144,5705000,21,31000,DeKalb County,DeKalb County-Jefferson County-AL
3683,DeKalb County-King County-WA-1920,"King County, WA",1920,2019,2020,176,12937000,209,9721000,-33,3216000,DeKalb County,DeKalb County-King County-WA
3684,DeKalb County-Philadelphia County-PA-1920,"Philadelphia County, PA",1920,2019,2020,163,6602000,116,4265000,47,2337000,DeKalb County,DeKalb County-Philadelphia County-PA
3685,DeKalb County-Shelby County-TN-1920,"Shelby County, TN",1920,2019,2020,160,5540000,171,4047000,-11,1493000,DeKalb County,DeKalb County-Shelby County-TN
3686,DeKalb County-Maricopa County-AZ-1920,"Maricopa County, AZ",1920,2019,2020,199,7788000,185,6518000,14,1270000,DeKalb County,DeKalb County-Maricopa County-AZ
3687,DeKalb County-San Diego County-CA-1920,"San Diego County, CA",1920,2019,2020,151,6367000,148,5357000,3,1010000,DeKalb County,DeKalb County-San Diego County-CA
3688,DeKalb County-Prince George's County-MD-1920,"Prince George's County, MD",1920,2019,2020,131,4160000,84,3276000,47,884000,DeKalb County,DeKalb County-Prince George's County-MD
3689,DeKalb County-Paulding County-GA-1920,"Paulding County, GA",1920,2019,2020,137,2738000,260,5713000,-123,-2975000,DeKalb County,DeKalb County-Paulding County-GA
3690,DeKalb County-Montgomery County-MD-1920,"Montgomery County, MD",1920,2019,2020,140,7202000,106,5245000,34,1957000,DeKalb County,DeKalb County-Montgomery County-MD
3691,DeKalb County-Franklin County-OH-1920,"Franklin County, OH",1920,2019,2020,144,3745000,130,3269000,14,476000,DeKalb County,DeKalb County-Franklin County-OH
3692,DeKalb County-Bronx County-NY-1920,"Bronx County, NY",1920,2019,2020,150,3580000,46,602000,104,2978000,DeKalb County,DeKalb County-Bronx County-NY
3693,DeKalb County-Richland County-SC-1920,"Richland County, SC",1920,2019,2020,133,3190000,113,3007000,20,183000,DeKalb County,DeKalb County-Richland County-SC
3694,DeKalb County-Leon County-FL-1920,"Leon County, FL",1920,2019,2020,107,2999000,59,1763000,48,1236000,DeKalb County,DeKalb County-Leon County-FL
3695,DeKalb County-Essex County-NJ-1920,"Essex County, NJ",1920,2019,2020,157,4208000,47,1589000,110,2619000,DeKalb County,DeKalb County-Essex County-NJ
3696,DeKalb County-Wake County-NC-1920,"Wake County, NC",1920,2019,2020,131,4854000,160,7409000,-29,-2555000,DeKalb County,DeKalb County-Wake County-NC
3697,DeKalb County-Middlesex County-MA-1920,"Middlesex County, MA",1920,2019,2020,112,7579000,80,4515000,32,3064000,DeKalb County,DeKalb County-Middlesex County-MA
3698,DeKalb County-Suffolk County-MA-1920,"Suffolk County, MA",1920,2019,2020,104,5062000,90,5835000,14,-773000,DeKalb County,DeKalb County-Suffolk County-MA
3699,DeKalb County-Wayne County-MI-1920,"Wayne County, MI",1920,2019,2020,130,2074000,105,1984000,25,90000,DeKalb County,DeKalb County-Wayne County-MI
3700,DeKalb County-Travis County-TX-1920,"Travis County, TX",1920,2019,2020,101,4758000,112,6344000,-11,-1586000,DeKalb County,DeKalb County-Travis County-TX
3701,DeKalb County-Alameda County-CA-1920,"Alameda County, CA",1920,2019,2020,125,7066000,94,3413000,31,3653000,DeKalb County,DeKalb County-Alameda County-CA
3702,DeKalb County-Marion County-IN-1920,"Marion County, IN",1920,2019,2020,120,2861000,89,1522000,31,1339000,DeKalb County,DeKalb County-Marion County-IN
3703,DeKalb County-San Francisco County-CA-1920,"San Francisco County, CA",1920,2019,2020,101,18913000,70,4485000,31,14428000,DeKalb County,DeKalb County-San Francisco County-CA
3704,DeKalb County-Cuyahoga County-OH-1920,"Cuyahoga County, OH",1920,2019,2020,125,3049000,118,2741000,7,308000,DeKalb County,DeKalb County-Cuyahoga County-OH
3705,DeKalb County-Pinellas County-FL-1920,"Pinellas County, FL",1920,2019,2020,113,3947000,169,11855000,-56,-7908000,DeKalb County,DeKalb County-Pinellas County-FL
3706,DeKalb County-Carroll County-GA-1920,"Carroll County, GA",1920,2019,2020,98,1762000,154,3139000,-56,-1377000,DeKalb County,DeKalb County-Carroll County-GA
3707,DeKalb County-Nassau County-NY-1920,"Nassau County, NY",1920,2019,2020,104,4662000,45,1373000,59,3289000,DeKalb County,DeKalb County-Nassau County-NY
3708,DeKalb County-Charleston County-SC-1920,"Charleston County, SC",1920,2019,2020,109,4880000,120,7737000,-11,-2857000,DeKalb County,DeKalb County-Charleston County-SC
3709,DeKalb County-Greenville County-SC-1920,"Greenville County, SC",1920,2019,2020,103,3112000,97,6058000,6,-2946000,DeKalb County,DeKalb County-Greenville County-SC
3710,DeKalb County-Clark County-NV-1920,"Clark County, NV",1920,2019,2020,105,2055000,141,5128000,-36,-3073000,DeKalb County,DeKalb County-Clark County-NV
3711,DeKalb County-Allegheny County-PA-1920,"Allegheny County, PA",1920,2019,2020,115,4692000,89,2798000,26,1894000,DeKalb County,DeKalb County-Allegheny County-PA
3712,DeKalb County-Dougherty County-GA-1920,"Dougherty County, GA",1920,2019,2020,107,1565000,55,879000,52,686000,DeKalb County,DeKalb County-Dougherty County-GA
3713,DeKalb County-Hennepin County-MN-1920,"Hennepin County, MN",1920,2019,2020,108,4606000,69,2210000,39,2396000,DeKalb County,DeKalb County-Hennepin County-MN
3714,DeKalb County-Denver County-CO-1920,"Denver County, CO",1920,2019,2020,82,6099000,117,6111000,-35,-12000,DeKalb County,DeKalb County-Denver County-CO
3715,DeKalb County-Orleans Parish-LA-1920,"Orleans Parish, LA",1920,2019,2020,89,1918000,62,1853000,27,65000,DeKalb County,DeKalb County-Orleans Parish-LA
3716,DeKalb County-Durham County-NC-1920,"Durham County, NC",1920,2019,2020,95,5131000,84,2915000,11,2216000,DeKalb County,DeKalb County-Durham County-NC
3717,DeKalb County-Hamilton County-TN-1920,"Hamilton County, TN",1920,2019,2020,99,3882000,132,6867000,-33,-2985000,DeKalb County,DeKalb County-Hamilton County-TN
3718,DeKalb County-Fairfax County-VA-1920,"Fairfax County, VA",1920,2019,2020,92,4830000,118,6481000,-26,-1651000,DeKalb County,DeKalb County-Fairfax County-VA
3719,DeKalb County-Santa Clara County-CA-1920,"Santa Clara County, CA",1920,2019,2020,85,8868000,79,6425000,6,2443000,DeKalb County,DeKalb County-Santa Clara County-CA
3720,DeKalb County-Knox County-TN-1920,"Knox County, TN",1920,2019,2020,95,2627000,104,2628000,-9,-1000,DeKalb County,DeKalb County-Knox County-TN
3721,DeKalb County-Baltimore city-MD-1920,"Baltimore city, MD",1920,2019,2020,84,2281000,78,2145000,6,136000,DeKalb County,DeKalb County-Baltimore city-MD
3722,DeKalb County-Guilford County-NC-1920,"Guilford County, NC",1920,2019,2020,83,2348000,91,1868000,-8,480000,DeKalb County,DeKalb County-Guilford County-NC
3723,DeKalb County-Barrow County-GA-1920,"Barrow County, GA",1920,2019,2020,88,1856000,143,3614000,-55,-1758000,DeKalb County,DeKalb County-Barrow County-GA
3724,DeKalb County-Houston County-GA-1920,"Houston County, GA",1920,2019,2020,82,2384000,101,3486000,-19,-1102000,DeKalb County,DeKalb County-Houston County-GA
3725,DeKalb County-Hamilton County-OH-1920,"Hamilton County, OH",1920,2019,2020,92,3181000,113,3232000,-21,-51000,DeKalb County,DeKalb County-Hamilton County-OH
3726,DeKalb County-Alachua County-FL-1920,"Alachua County, FL",1920,2019,2020,89,2604000,59,2249000,30,355000,DeKalb County,DeKalb County-Alachua County-FL
3727,DeKalb County-Lowndes County-GA-1920,"Lowndes County, GA",1920,2019,2020,86,1576000,40,491000,46,1085000,DeKalb County,DeKalb County-Lowndes County-GA
3728,DeKalb County-Fairfield County-CT-1920,"Fairfield County, CT",1920,2019,2020,90,4166000,51,2959000,39,1207000,DeKalb County,DeKalb County-Fairfield County-CT
3729,DeKalb County-Mobile County-AL-1920,"Mobile County, AL",1920,2019,2020,101,1663000,59,1296000,42,367000,DeKalb County,DeKalb County-Mobile County-AL
3730,DeKalb County-Spalding County-GA-1920,"Spalding County, GA",1920,2019,2020,94,1747000,148,2770000,-54,-1023000,DeKalb County,DeKalb County-Spalding County-GA
3731,DeKalb County-Hudson County-NJ-1920,"Hudson County, NJ",1920,2019,2020,79,3419000,40,1359000,39,2060000,DeKalb County,DeKalb County-Hudson County-NJ
3732,DeKalb County-Tarrant County-TX-1920,"Tarrant County, TX",1920,2019,2020,72,2898000,125,3075000,-53,-177000,DeKalb County,DeKalb County-Tarrant County-TX
3733,DeKalb County-Orange County-CA-1920,"Orange County, CA",1920,2019,2020,68,3801000,76,2528000,-8,1273000,DeKalb County,DeKalb County-Orange County-CA
3734,DeKalb County-Montgomery County-AL-1920,"Montgomery County, AL",1920,2019,2020,63,1845000,93,1823000,-30,22000,DeKalb County,DeKalb County-Montgomery County-AL
3735,DeKalb County-Madison County-AL-1920,"Madison County, AL",1920,2019,2020,71,1994000,64,1834000,7,160000,DeKalb County,DeKalb County-Madison County-AL
3736,DeKalb County-Hartford County-CT-1920,"Hartford County, CT",1920,2019,2020,80,3579000,60,1816000,20,1763000,DeKalb County,DeKalb County-Hartford County-CT
3737,DeKalb County-Bulloch County-GA-1920,"Bulloch County, GA",1920,2019,2020,64,1168000,32,1036000,32,132000,DeKalb County,DeKalb County-Bulloch County-GA
3738,DeKalb County-East Baton Rouge Parish-LA-1920,"East Baton Rouge Parish, LA",1920,2019,2020,73,2109000,48,749000,25,1360000,DeKalb County,DeKalb County-East Baton Rouge Parish-LA
3739,DeKalb County-Columbia County-GA-1920,"Columbia County, GA",1920,2019,2020,74,2448000,71,2534000,3,-86000,DeKalb County,DeKalb County-Columbia County-GA
3740,DeKalb County-Baltimore County-MD-1920,"Baltimore County, MD",1920,2019,2020,76,1923000,43,1944000,33,-21000,DeKalb County,DeKalb County-Baltimore County-MD
3741,DeKalb County-St. Louis County-MO-1920,"St. Louis County, MO",1920,2019,2020,70,2383000,84,2808000,-14,-425000,DeKalb County,DeKalb County-St. Louis County-MO
3742,DeKalb County-Oakland County-MI-1920,"Oakland County, MI",1920,2019,2020,82,3472000,68,2815000,14,657000,DeKalb County,DeKalb County-Oakland County-MI
3743,DeKalb County-Monroe County-NY-1920,"Monroe County, NY",1920,2019,2020,64,1898000,32,929000,32,969000,DeKalb County,DeKalb County-Monroe County-NY
3744,DeKalb County-Bexar County-TX-1920,"Bexar County, TX",1920,2019,2020,72,2687000,106,3847000,-34,-1160000,DeKalb County,DeKalb County-Bexar County-TX
3745,DeKalb County-Collin County-TX-1920,"Collin County, TX",1920,2019,2020,69,1925000,73,3569000,-4,-1644000,DeKalb County,DeKalb County-Collin County-TX
3746,DeKalb County-Milwaukee County-WI-1920,"Milwaukee County, WI",1920,2019,2020,77,1583000,116,1788000,-39,-205000,DeKalb County,DeKalb County-Milwaukee County-WI
3747,DeKalb County-Jefferson County-KY-1920,"Jefferson County, KY",1920,2019,2020,72,2250000,76,3268000,-4,-1018000,DeKalb County,DeKalb County-Jefferson County-KY
3748,DeKalb County-Jefferson Parish-LA-1920,"Jefferson Parish, LA",1920,2019,2020,66,1812000,37,677000,29,1135000,DeKalb County,DeKalb County-Jefferson Parish-LA
3749,DeKalb County-Seminole County-FL-1920,"Seminole County, FL",1920,2019,2020,76,2497000,65,1513000,11,984000,DeKalb County,DeKalb County-Seminole County-FL
3750,DeKalb County-Bartow County-GA-1920,"Bartow County, GA",1920,2019,2020,59,1517000,86,2091000,-27,-574000,DeKalb County,DeKalb County-Bartow County-GA
3751,DeKalb County-Escambia County-FL-1920,"Escambia County, FL",1920,2019,2020,54,1479000,55,1581000,-1,-102000,DeKalb County,DeKalb County-Escambia County-FL
3752,DeKalb County-Westchester County-NY-1920,"Westchester County, NY",1920,2019,2020,56,2081000,41,1733000,15,348000,DeKalb County,DeKalb County-Westchester County-NY
3753,DeKalb County-Kent County-MI-1920,"Kent County, MI",1920,2019,2020,70,1610000,46,648000,24,962000,DeKalb County,DeKalb County-Kent County-MI
3754,DeKalb County-Erie County-NY-1920,"Erie County, NY",1920,2019,2020,67,1592000,59,1100000,8,492000,DeKalb County,DeKalb County-Erie County-NY
3755,DeKalb County-Glynn County-GA-1920,"Glynn County, GA",1920,2019,2020,62,1805000,74,6131000,-12,-4326000,DeKalb County,DeKalb County-Glynn County-GA
3756,DeKalb County-Volusia County-FL-1920,"Volusia County, FL",1920,2019,2020,49,970000,55,1874000,-6,-904000,DeKalb County,DeKalb County-Volusia County-FL
3757,DeKalb County-Arlington County-VA-1920,"Arlington County, VA",1920,2019,2020,62,3380000,27,2377000,35,1003000,DeKalb County,DeKalb County-Arlington County-VA
3758,DeKalb County-New Haven County-CT-1920,"New Haven County, CT",1920,2019,2020,47,1671000,41,1424000,6,247000,DeKalb County,DeKalb County-New Haven County-CT
3759,DeKalb County-Lee County-FL-1920,"Lee County, FL",1920,2019,2020,57,1139000,64,3617000,-7,-2478000,DeKalb County,DeKalb County-Lee County-FL
3760,DeKalb County-Buncombe County-NC-1920,"Buncombe County, NC",1920,2019,2020,51,2932000,79,5565000,-28,-2633000,DeKalb County,DeKalb County-Buncombe County-NC
3761,DeKalb County-Virginia Beach city-VA-1920,"Virginia Beach city, VA",1920,2019,2020,49,2351000,64,2059000,-15,292000,DeKalb County,DeKalb County-Virginia Beach city-VA
3762,DeKalb County-Troup County-GA-1920,"Troup County, GA",1920,2019,2020,61,1165000,70,1959000,-9,-794000,DeKalb County,DeKalb County-Troup County-GA
3763,DeKalb County-Lee County-AL-1920,"Lee County, AL",1920,2019,2020,39,1324000,60,3821000,-21,-2497000,DeKalb County,DeKalb County-Lee County-AL
3764,DeKalb County-Sacramento County-CA-1920,"Sacramento County, CA",1920,2019,2020,59,1577000,50,1609000,9,-32000,DeKalb County,DeKalb County-Sacramento County-CA
3765,DeKalb County-Arapahoe County-CO-1920,"Arapahoe County, CO",1920,2019,2020,52,1504000,58,2189000,-6,-685000,DeKalb County,DeKalb County-Arapahoe County-CO
3766,DeKalb County-Multnomah County-OR-1920,"Multnomah County, OR",1920,2019,2020,44,1271000,51,1828000,-7,-557000,DeKalb County,DeKalb County-Multnomah County-OR
3767,DeKalb County-Henrico County-VA-1920,"Henrico County, VA",1920,2019,2020,43,2348000,47,3190000,-4,-842000,DeKalb County,DeKalb County-Henrico County-VA
3768,DeKalb County-Polk County-FL-1920,"Polk County, FL",1920,2019,2020,52,1119000,65,1908000,-13,-789000,DeKalb County,DeKalb County-Polk County-FL
3769,DeKalb County-Norfolk city-VA-1920,"Norfolk city, VA",1920,2019,2020,46,2456000,30,659000,16,1797000,DeKalb County,DeKalb County-Norfolk city-VA
3770,DeKalb County-Forsyth County-NC-1920,"Forsyth County, NC",1920,2019,2020,44,2156000,68,2187000,-24,-31000,DeKalb County,DeKalb County-Forsyth County-NC
3771,DeKalb County-Beaufort County-SC-1920,"Beaufort County, SC",1920,2019,2020,45,1872000,72,6006000,-27,-4134000,DeKalb County,DeKalb County-Beaufort County-SC
3772,DeKalb County-Jackson County-GA-1920,"Jackson County, GA",1920,2019,2020,35,1337000,88,5021000,-53,-3684000,DeKalb County,DeKalb County-Jackson County-GA
3773,DeKalb County-Richmond city-VA-1920,"Richmond city, VA",1920,2019,2020,38,1505000,29,805000,9,700000,DeKalb County,DeKalb County-Richmond city-VA
3774,DeKalb County-Brevard County-FL-1920,"Brevard County, FL",1920,2019,2020,47,1277000,72,2978000,-25,-1701000,DeKalb County,DeKalb County-Brevard County-FL
3775,DeKalb County-Liberty County-GA-1920,"Liberty County, GA",1920,2019,2020,47,763000,43,725000,4,38000,DeKalb County,DeKalb County-Liberty County-GA
3776,DeKalb County-St. Louis city-MO-1920,"St. Louis city, MO",1920,2019,2020,39,1337000,47,1347000,-8,-10000,DeKalb County,DeKalb County-St. Louis city-MO
3777,DeKalb County-Shelby County-AL-1920,"Shelby County, AL",1920,2019,2020,38,1169000,48,2070000,-10,-901000,DeKalb County,DeKalb County-Shelby County-AL
3778,DeKalb County-Loudoun County-VA-1920,"Loudoun County, VA",1920,2019,2020,40,2180000,79,2291000,-39,-111000,DeKalb County,DeKalb County-Loudoun County-VA
3779,DeKalb County-Hinds County-MS-1920,"Hinds County, MS",1920,2019,2020,56,1308000,38,399000,18,909000,DeKalb County,DeKalb County-Hinds County-MS
3780,DeKalb County-Riverside County-CA-1920,"Riverside County, CA",1920,2019,2020,44,799000,54,1400000,-10,-601000,DeKalb County,DeKalb County-Riverside County-CA
3781,DeKalb County-El Paso County-CO-1920,"El Paso County, CO",1920,2019,2020,41,625000,47,1976000,-6,-1351000,DeKalb County,DeKalb County-El Paso County-CO
3782,DeKalb County-New Castle County-DE-1920,"New Castle County, DE",1920,2019,2020,33,962000,44,1176000,-11,-214000,DeKalb County,DeKalb County-New Castle County-DE
3783,DeKalb County-Floyd County-GA-1920,"Floyd County, GA",1920,2019,2020,45,1170000,44,987000,1,183000,DeKalb County,DeKalb County-Floyd County-GA
3784,DeKalb County-Oconee County-GA-1920,"Oconee County, GA",1920,2019,2020,35,1692000,48,4920000,-13,-3228000,DeKalb County,DeKalb County-Oconee County-GA
3785,DeKalb County-Rutherford County-TN-1920,"Rutherford County, TN",1920,2019,2020,34,1084000,42,1125000,-8,-41000,DeKalb County,DeKalb County-Rutherford County-TN
3786,DeKalb County-Sarasota County-FL-1920,"Sarasota County, FL",1920,2019,2020,33,1507000,52,3644000,-19,-2137000,DeKalb County,DeKalb County-Sarasota County-FL
3787,DeKalb County-Baldwin County-GA-1920,"Baldwin County, GA",1920,2019,2020,34,724000,39,1230000,-5,-506000,DeKalb County,DeKalb County-Baldwin County-GA
3788,DeKalb County-Anne Arundel County-MD-1920,"Anne Arundel County, MD",1920,2019,2020,33,1012000,37,1213000,-4,-201000,DeKalb County,DeKalb County-Anne Arundel County-MD
3789,DeKalb County-Dauphin County-PA-1920,"Dauphin County, PA",1920,2019,2020,34,1569000,62,925000,-28,644000,DeKalb County,DeKalb County-Dauphin County-PA
3790,DeKalb County-Denton County-TX-1920,"Denton County, TX",1920,2019,2020,27,1117000,52,2645000,-25,-1528000,DeKalb County,DeKalb County-Denton County-TX
3791,DeKalb County-Alexandria city-VA-1920,"Alexandria city, VA",1920,2019,2020,33,2507000,44,2304000,-11,203000,DeKalb County,DeKalb County-Alexandria city-VA
3793,Douglas County-Cobb County-GA-1920,"Cobb County, GA",1920,2019,2020,2980,55016000,1935,41779000,1045,13237000,Douglas County,Douglas County-Cobb County-GA
3794,Douglas County-Fulton County-GA-1920,"Fulton County, GA",1920,2019,2020,1828,38047000,1511,27819000,317,10228000,Douglas County,Douglas County-Fulton County-GA
3795,Douglas County-Carroll County-GA-1920,"Carroll County, GA",1920,2019,2020,1051,22406000,1655,42505000,-604,-20099000,Douglas County,Douglas County-Carroll County-GA
3796,Douglas County-Paulding County-GA-1920,"Paulding County, GA",1920,2019,2020,1010,19393000,1346,29735000,-336,-10342000,Douglas County,Douglas County-Paulding County-GA
3797,Douglas County-DeKalb County-GA-1920,"DeKalb County, GA",1920,2019,2020,551,10184000,437,9311000,114,873000,Douglas County,Douglas County-DeKalb County-GA
3798,Douglas County-Clayton County-GA-1920,"Clayton County, GA",1920,2019,2020,485,7271000,284,4469000,201,2802000,Douglas County,Douglas County-Clayton County-GA
3799,Douglas County-Gwinnett County-GA-1920,"Gwinnett County, GA",1920,2019,2020,355,7073000,350,5575000,5,1498000,Douglas County,Douglas County-Gwinnett County-GA
3800,Douglas County-Henry County-GA-1920,"Henry County, GA",1920,2019,2020,126,2298000,165,3324000,-39,-1026000,Douglas County,Douglas County-Henry County-GA
3801,Douglas County-Broward County-FL-1920,"Broward County, FL",1920,2019,2020,121,2752000,43,849000,78,1903000,Douglas County,Douglas County-Broward County-FL
3802,Douglas County-Coweta County-GA-1920,"Coweta County, GA",1920,2019,2020,96,2610000,192,5953000,-96,-3343000,Douglas County,Douglas County-Coweta County-GA
3803,Douglas County-Cherokee County-GA-1920,"Cherokee County, GA",1920,2019,2020,91,1557000,126,3775000,-35,-2218000,Douglas County,Douglas County-Cherokee County-GA
3804,Douglas County-Fayette County-GA-1920,"Fayette County, GA",1920,2019,2020,78,1828000,127,5129000,-49,-3301000,Douglas County,Douglas County-Fayette County-GA
3805,Douglas County-Haralson County-GA-1920,"Haralson County, GA",1920,2019,2020,77,1491000,213,4942000,-136,-3451000,Douglas County,Douglas County-Haralson County-GA
3806,Douglas County-Muscogee County-GA-1920,"Muscogee County, GA",1920,2019,2020,55,671000,43,958000,12,-287000,Douglas County,Douglas County-Muscogee County-GA
3807,Douglas County-Duval County-FL-1920,"Duval County, FL",1920,2019,2020,51,1055000,51,650000,0,405000,Douglas County,Douglas County-Duval County-FL
3808,Douglas County-Newton County-GA-1920,"Newton County, GA",1920,2019,2020,46,1029000,49,722000,-3,307000,Douglas County,Douglas County-Newton County-GA
3809,Douglas County-Rockdale County-GA-1920,"Rockdale County, GA",1920,2019,2020,47,867000,47,959000,0,-92000,Douglas County,Douglas County-Rockdale County-GA
3810,Douglas County-Jefferson County-AL-1920,"Jefferson County, AL",1920,2019,2020,39,964000,44,1012000,-5,-48000,Douglas County,Douglas County-Jefferson County-AL
3811,Douglas County-Bartow County-GA-1920,"Bartow County, GA",1920,2019,2020,57,818000,86,1627000,-29,-809000,Douglas County,Douglas County-Bartow County-GA
3813,Fayette County-Fulton County-GA-1920,"Fulton County, GA",1920,2019,2020,1336,44729000,984,41997000,352,2732000,Fayette County,Fayette County-Fulton County-GA
3814,Fayette County-Coweta County-GA-1920,"Coweta County, GA",1920,2019,2020,1056,43991000,1697,70288000,-641,-26297000,Fayette County,Fayette County-Coweta County-GA
3815,Fayette County-Clayton County-GA-1920,"Clayton County, GA",1920,2019,2020,1042,48752000,573,9717000,469,39035000,Fayette County,Fayette County-Clayton County-GA
3816,Fayette County-Henry County-GA-1920,"Henry County, GA",1920,2019,2020,525,16316000,339,8048000,186,8268000,Fayette County,Fayette County-Henry County-GA
3817,Fayette County-DeKalb County-GA-1920,"DeKalb County, GA",1920,2019,2020,319,11662000,181,11712000,138,-50000,Fayette County,Fayette County-DeKalb County-GA
3818,Fayette County-Cobb County-GA-1920,"Cobb County, GA",1920,2019,2020,324,14546000,238,9771000,86,4775000,Fayette County,Fayette County-Cobb County-GA
3819,Fayette County-Los Angeles County-CA-1920,"Los Angeles County, CA",1920,2019,2020,153,7955000,52,1774000,101,6181000,Fayette County,Fayette County-Los Angeles County-CA
3820,Fayette County-Spalding County-GA-1920,"Spalding County, GA",1920,2019,2020,202,4072000,171,5909000,31,-1837000,Fayette County,Fayette County-Spalding County-GA
3821,Fayette County-Gwinnett County-GA-1920,"Gwinnett County, GA",1920,2019,2020,154,4227000,172,4745000,-18,-518000,Fayette County,Fayette County-Gwinnett County-GA
3822,Fayette County-Douglas County-GA-1920,"Douglas County, GA",1920,2019,2020,127,5129000,78,1828000,49,3301000,Fayette County,Fayette County-Douglas County-GA
3823,Fayette County-Cherokee County-GA-1920,"Cherokee County, GA",1920,2019,2020,42,1946000,46,1972000,-4,-26000,Fayette County,Fayette County-Cherokee County-GA
3824,Fayette County-Meriwether County-GA-1920,"Meriwether County, GA",1920,2019,2020,45,816000,66,1792000,-21,-976000,Fayette County,Fayette County-Meriwether County-GA
3826,Forsyth County-Fulton County-GA-1920,"Fulton County, GA",1920,2019,2020,5819,261178000,2667,170264000,3152,90914000,Forsyth County,Forsyth County-Fulton County-GA
3827,Forsyth County-Gwinnett County-GA-1920,"Gwinnett County, GA",1920,2019,2020,2527,102955000,1644,60478000,883,42477000,Forsyth County,Forsyth County-Gwinnett County-GA
3828,Forsyth County-Cobb County-GA-1920,"Cobb County, GA",1920,2019,2020,1099,46800000,446,21167000,653,25633000,Forsyth County,Forsyth County-Cobb County-GA
3829,Forsyth County-DeKalb County-GA-1920,"DeKalb County, GA",1920,2019,2020,1074,44701000,385,20063000,689,24638000,Forsyth County,Forsyth County-DeKalb County-GA
3830,Forsyth County-Hall County-GA-1920,"Hall County, GA",1920,2019,2020,612,19963000,956,40503000,-344,-20540000,Forsyth County,Forsyth County-Hall County-GA
3831,Forsyth County-Cherokee County-GA-1920,"Cherokee County, GA",1920,2019,2020,662,28971000,941,46300000,-279,-17329000,Forsyth County,Forsyth County-Cherokee County-GA
3832,Forsyth County-Dawson County-GA-1920,"Dawson County, GA",1920,2019,2020,470,14269000,1149,37380000,-679,-23111000,Forsyth County,Forsyth County-Dawson County-GA
3833,Forsyth County-Lumpkin County-GA-1920,"Lumpkin County, GA",1920,2019,2020,182,4558000,410,11476000,-228,-6918000,Forsyth County,Forsyth County-Lumpkin County-GA
3834,Forsyth County-Broward County-FL-1920,"Broward County, FL",1920,2019,2020,141,7070000,67,3743000,74,3327000,Forsyth County,Forsyth County-Broward County-FL
3835,Forsyth County-Los Angeles County-CA-1920,"Los Angeles County, CA",1920,2019,2020,117,4832000,68,2315000,49,2517000,Forsyth County,Forsyth County-Los Angeles County-CA
3836,Forsyth County-Henry County-GA-1920,"Henry County, GA",1920,2019,2020,120,6096000,49,1813000,71,4283000,Forsyth County,Forsyth County-Henry County-GA
3837,Forsyth County-Pickens County-GA-1920,"Pickens County, GA",1920,2019,2020,84,3929000,243,11295000,-159,-7366000,Forsyth County,Forsyth County-Pickens County-GA
3838,Forsyth County-Jackson County-GA-1920,"Jackson County, GA",1920,2019,2020,88,3408000,126,4435000,-38,-1027000,Forsyth County,Forsyth County-Jackson County-GA
3839,Forsyth County-Orange County-FL-1920,"Orange County, FL",1920,2019,2020,75,2567000,45,2505000,30,62000,Forsyth County,Forsyth County-Orange County-FL
3840,Forsyth County-Mecklenburg County-NC-1920,"Mecklenburg County, NC",1920,2019,2020,89,2968000,59,2919000,30,49000,Forsyth County,Forsyth County-Mecklenburg County-NC
3841,Forsyth County-San Diego County-CA-1920,"San Diego County, CA",1920,2019,2020,77,1668000,71,2818000,6,-1150000,Forsyth County,Forsyth County-San Diego County-CA
3842,Forsyth County-Barrow County-GA-1920,"Barrow County, GA",1920,2019,2020,56,1996000,85,1737000,-29,259000,Forsyth County,Forsyth County-Barrow County-GA
3843,Forsyth County-Clarke County-GA-1920,"Clarke County, GA",1920,2019,2020,54,1356000,61,2322000,-7,-966000,Forsyth County,Forsyth County-Clarke County-GA
3844,Forsyth County-Palm Beach County-FL-1920,"Palm Beach County, FL",1920,2019,2020,89,2977000,39,2768000,50,209000,Forsyth County,Forsyth County-Palm Beach County-FL
3845,Forsyth County-Harris County-TX-1920,"Harris County, TX",1920,2019,2020,69,3766000,66,3680000,3,86000,Forsyth County,Forsyth County-Harris County-TX
3846,Forsyth County-Maricopa County-AZ-1920,"Maricopa County, AZ",1920,2019,2020,84,3212000,77,5476000,7,-2264000,Forsyth County,Forsyth County-Maricopa County-AZ
3847,Forsyth County-Hillsborough County-FL-1920,"Hillsborough County, FL",1920,2019,2020,71,2776000,73,3976000,-2,-1200000,Forsyth County,Forsyth County-Hillsborough County-FL
3848,Forsyth County-White County-GA-1920,"White County, GA",1920,2019,2020,73,1539000,135,4574000,-62,-3035000,Forsyth County,Forsyth County-White County-GA
3849,Forsyth County-Dallas County-TX-1920,"Dallas County, TX",1920,2019,2020,50,4687000,57,2838000,-7,1849000,Forsyth County,Forsyth County-Dallas County-TX
3850,Forsyth County-Wake County-NC-1920,"Wake County, NC",1920,2019,2020,63,1901000,62,3971000,1,-2070000,Forsyth County,Forsyth County-Wake County-NC
3851,Forsyth County-Chatham County-GA-1920,"Chatham County, GA",1920,2019,2020,34,844000,37,2659000,-3,-1815000,Forsyth County,Forsyth County-Chatham County-GA
3852,Forsyth County-Duval County-FL-1920,"Duval County, FL",1920,2019,2020,40,1539000,73,2725000,-33,-1186000,Forsyth County,Forsyth County-Duval County-FL
3853,Forsyth County-King County-WA-1920,"King County, WA",1920,2019,2020,43,1961000,47,3609000,-4,-1648000,Forsyth County,Forsyth County-King County-WA
3854,Forsyth County-Greenville County-SC-1920,"Greenville County, SC",1920,2019,2020,46,2363000,43,1405000,3,958000,Forsyth County,Forsyth County-Greenville County-SC
3856,Fulton County-DeKalb County-GA-1920,"DeKalb County, GA",1920,2019,2020,14267,672510000,14585,732016000,-318,-59506000,Fulton County,Fulton County-DeKalb County-GA
3857,Fulton County-Cobb County-GA-1920,"Cobb County, GA",1920,2019,2020,8639,458587000,9931,499533000,-1292,-40946000,Fulton County,Fulton County-Cobb County-GA
3858,Fulton County-Gwinnett County-GA-1920,"Gwinnett County, GA",1920,2019,2020,6012,248248000,6565,232753000,-553,15495000,Fulton County,Fulton County-Gwinnett County-GA
3859,Fulton County-Clayton County-GA-1920,"Clayton County, GA",1920,2019,2020,6869,93887000,7522,95274000,-653,-1387000,Fulton County,Fulton County-Clayton County-GA
3860,Fulton County-Forsyth County-GA-1920,"Forsyth County, GA",1920,2019,2020,2667,170264000,5819,261178000,-3152,-90914000,Fulton County,Fulton County-Forsyth County-GA
3861,Fulton County-Douglas County-GA-1920,"Douglas County, GA",1920,2019,2020,1511,27819000,1828,38047000,-317,-10228000,Fulton County,Fulton County-Douglas County-GA
3862,Fulton County-Cherokee County-GA-1920,"Cherokee County, GA",1920,2019,2020,1219,69584000,2757,134106000,-1538,-64522000,Fulton County,Fulton County-Cherokee County-GA
3863,Fulton County-Henry County-GA-1920,"Henry County, GA",1920,2019,2020,1332,35376000,1738,42610000,-406,-7234000,Fulton County,Fulton County-Henry County-GA
3864,Fulton County-Los Angeles County-CA-1920,"Los Angeles County, CA",1920,2019,2020,956,62386000,648,48677000,308,13709000,Fulton County,Fulton County-Los Angeles County-CA
3865,Fulton County-Cook County-IL-1920,"Cook County, IL",1920,2019,2020,910,58965000,619,41830000,291,17135000,Fulton County,Fulton County-Cook County-IL
3866,Fulton County-Fayette County-GA-1920,"Fayette County, GA",1920,2019,2020,984,41997000,1336,44729000,-352,-2732000,Fulton County,Fulton County-Fayette County-GA
3867,Fulton County-New York County-NY-1920,"New York County, NY",1920,2019,2020,743,92170000,391,46205000,352,45965000,Fulton County,Fulton County-New York County-NY
3868,Fulton County-Kings County-NY-1920,"Kings County, NY",1920,2019,2020,630,37219000,265,11160000,365,26059000,Fulton County,Fulton County-Kings County-NY
3869,Fulton County-Broward County-FL-1920,"Broward County, FL",1920,2019,2020,688,26414000,438,21971000,250,4443000,Fulton County,Fulton County-Broward County-FL
3870,Fulton County-Miami-Dade County-FL-1920,"Miami-Dade County, FL",1920,2019,2020,678,36289000,438,74644000,240,-38355000,Fulton County,Fulton County-Miami-Dade County-FL
3871,Fulton County-Coweta County-GA-1920,"Coweta County, GA",1920,2019,2020,743,22143000,996,36244000,-253,-14101000,Fulton County,Fulton County-Coweta County-GA
3872,Fulton County-Mecklenburg County-NC-1920,"Mecklenburg County, NC",1920,2019,2020,524,46470000,658,42763000,-134,3707000,Fulton County,Fulton County-Mecklenburg County-NC
3873,Fulton County-Harris County-TX-1920,"Harris County, TX",1920,2019,2020,443,31379000,418,24068000,25,7311000,Fulton County,Fulton County-Harris County-TX
3874,Fulton County-Clarke County-GA-1920,"Clarke County, GA",1920,2019,2020,356,12196000,197,9760000,159,2436000,Fulton County,Fulton County-Clarke County-GA
3875,Fulton County-Dallas County-TX-1920,"Dallas County, TX",1920,2019,2020,421,41345000,372,29644000,49,11701000,Fulton County,Fulton County-Dallas County-TX
3876,Fulton County-Orange County-FL-1920,"Orange County, FL",1920,2019,2020,439,21459000,336,23080000,103,-1621000,Fulton County,Fulton County-Orange County-FL
3877,Fulton County-Palm Beach County-FL-1920,"Palm Beach County, FL",1920,2019,2020,405,28511000,349,30305000,56,-1794000,Fulton County,Fulton County-Palm Beach County-FL
3878,Fulton County-Paulding County-GA-1920,"Paulding County, GA",1920,2019,2020,430,11212000,611,18564000,-181,-7352000,Fulton County,Fulton County-Paulding County-GA
3879,Fulton County-Davidson County-TN-1920,"Davidson County, TN",1920,2019,2020,317,16678000,318,24662000,-1,-7984000,Fulton County,Fulton County-Davidson County-TN
3880,Fulton County-Jefferson County-AL-1920,"Jefferson County, AL",1920,2019,2020,342,20446000,236,14871000,106,5575000,Fulton County,Fulton County-Jefferson County-AL
3881,Fulton County-Hillsborough County-FL-1920,"Hillsborough County, FL",1920,2019,2020,369,18225000,422,28834000,-53,-10609000,Fulton County,Fulton County-Hillsborough County-FL
3882,Fulton County-Duval County-FL-1920,"Duval County, FL",1920,2019,2020,373,28187000,317,12056000,56,16131000,Fulton County,Fulton County-Duval County-FL
3883,Fulton County-Queens County-NY-1920,"Queens County, NY",1920,2019,2020,325,16183000,135,4431000,190,11752000,Fulton County,Fulton County-Queens County-NY
3884,Fulton County-District of Columbia-DC-1920,"District of Columbia, DC",1920,2019,2020,257,20896000,237,18013000,20,2883000,Fulton County,Fulton County-District of Columbia-DC
3885,Fulton County-Rockdale County-GA-1920,"Rockdale County, GA",1920,2019,2020,385,8548000,482,9399000,-97,-851000,Fulton County,Fulton County-Rockdale County-GA
3886,Fulton County-Hall County-GA-1920,"Hall County, GA",1920,2019,2020,307,18049000,432,27556000,-125,-9507000,Fulton County,Fulton County-Hall County-GA
3887,Fulton County-Chatham County-GA-1920,"Chatham County, GA",1920,2019,2020,284,10498000,326,18698000,-42,-8200000,Fulton County,Fulton County-Chatham County-GA
3888,Fulton County-Wake County-NC-1920,"Wake County, NC",1920,2019,2020,300,16180000,278,14868000,22,1312000,Fulton County,Fulton County-Wake County-NC
3889,Fulton County-San Francisco County-CA-1920,"San Francisco County, CA",1920,2019,2020,233,35571000,161,14978000,72,20593000,Fulton County,Fulton County-San Francisco County-CA
3890,Fulton County-King County-WA-1920,"King County, WA",1920,2019,2020,311,23298000,476,37120000,-165,-13822000,Fulton County,Fulton County-King County-WA
3891,Fulton County-Alameda County-CA-1920,"Alameda County, CA",1920,2019,2020,296,25187000,172,9713000,124,15474000,Fulton County,Fulton County-Alameda County-CA
3892,Fulton County-Shelby County-TN-1920,"Shelby County, TN",1920,2019,2020,275,24233000,184,6163000,91,18070000,Fulton County,Fulton County-Shelby County-TN
3893,Fulton County-Travis County-TX-1920,"Travis County, TX",1920,2019,2020,240,25773000,304,19432000,-64,6341000,Fulton County,Fulton County-Travis County-TX
3894,Fulton County-Maricopa County-AZ-1920,"Maricopa County, AZ",1920,2019,2020,272,14260000,406,34350000,-134,-20090000,Fulton County,Fulton County-Maricopa County-AZ
3895,Fulton County-Muscogee County-GA-1920,"Muscogee County, GA",1920,2019,2020,269,8866000,236,6736000,33,2130000,Fulton County,Fulton County-Muscogee County-GA
3896,Fulton County-Franklin County-OH-1920,"Franklin County, OH",1920,2019,2020,232,9177000,175,7344000,57,1833000,Fulton County,Fulton County-Franklin County-OH
3897,Fulton County-Philadelphia County-PA-1920,"Philadelphia County, PA",1920,2019,2020,236,11084000,156,8159000,80,2925000,Fulton County,Fulton County-Philadelphia County-PA
3898,Fulton County-Newton County-GA-1920,"Newton County, GA",1920,2019,2020,310,5393000,333,7655000,-23,-2262000,Fulton County,Fulton County-Newton County-GA
3899,Fulton County-San Diego County-CA-1920,"San Diego County, CA",1920,2019,2020,240,10437000,229,13135000,11,-2698000,Fulton County,Fulton County-San Diego County-CA
3900,Fulton County-Hudson County-NJ-1920,"Hudson County, NJ",1920,2019,2020,217,26290000,108,5763000,109,20527000,Fulton County,Fulton County-Hudson County-NJ
3901,Fulton County-Middlesex County-MA-1920,"Middlesex County, MA",1920,2019,2020,198,14011000,182,11628000,16,2383000,Fulton County,Fulton County-Middlesex County-MA
3902,Fulton County-Carroll County-GA-1920,"Carroll County, GA",1920,2019,2020,206,5231000,250,6142000,-44,-911000,Fulton County,Fulton County-Carroll County-GA
3903,Fulton County-Fairfax County-VA-1920,"Fairfax County, VA",1920,2019,2020,250,15231000,156,9337000,94,5894000,Fulton County,Fulton County-Fairfax County-VA
3904,Fulton County-Santa Clara County-CA-1920,"Santa Clara County, CA",1920,2019,2020,244,20017000,305,26483000,-61,-6466000,Fulton County,Fulton County-Santa Clara County-CA
3905,Fulton County-Richmond County-GA-1920,"Richmond County, GA",1920,2019,2020,205,5347000,166,4080000,39,1267000,Fulton County,Fulton County-Richmond County-GA
3906,Fulton County-Prince George's County-MD-1920,"Prince George's County, MD",1920,2019,2020,212,6856000,143,4741000,69,2115000,Fulton County,Fulton County-Prince George's County-MD
3907,Fulton County-Suffolk County-MA-1920,"Suffolk County, MA",1920,2019,2020,172,13638000,124,7396000,48,6242000,Fulton County,Fulton County-Suffolk County-MA
3908,Fulton County-Clark County-NV-1920,"Clark County, NV",1920,2019,2020,227,7894000,196,8370000,31,-476000,Fulton County,Fulton County-Clark County-NV
3909,Fulton County-Montgomery County-MD-1920,"Montgomery County, MD",1920,2019,2020,205,16296000,172,12051000,33,4245000,Fulton County,Fulton County-Montgomery County-MD
3910,Fulton County-Bibb County-GA-1920,"Bibb County, GA",1920,2019,2020,206,8078000,159,3962000,47,4116000,Fulton County,Fulton County-Bibb County-GA
3911,Fulton County-Charleston County-SC-1920,"Charleston County, SC",1920,2019,2020,178,7358000,253,32331000,-75,-24973000,Fulton County,Fulton County-Charleston County-SC
3912,Fulton County-Wayne County-MI-1920,"Wayne County, MI",1920,2019,2020,195,5147000,169,4026000,26,1121000,Fulton County,Fulton County-Wayne County-MI
3913,Fulton County-Leon County-FL-1920,"Leon County, FL",1920,2019,2020,177,11275000,91,4014000,86,7261000,Fulton County,Fulton County-Leon County-FL
3914,Fulton County-Pinellas County-FL-1920,"Pinellas County, FL",1920,2019,2020,167,7925000,236,29472000,-69,-21547000,Fulton County,Fulton County-Pinellas County-FL
3915,Fulton County-Oakland County-MI-1920,"Oakland County, MI",1920,2019,2020,207,13106000,82,3769000,125,9337000,Fulton County,Fulton County-Oakland County-MI
3916,Fulton County-Allegheny County-PA-1920,"Allegheny County, PA",1920,2019,2020,197,10850000,140,5573000,57,5277000,Fulton County,Fulton County-Allegheny County-PA
3917,Fulton County-Hennepin County-MN-1920,"Hennepin County, MN",1920,2019,2020,181,12215000,155,8477000,26,3738000,Fulton County,Fulton County-Hennepin County-MN
3918,Fulton County-Essex County-NJ-1920,"Essex County, NJ",1920,2019,2020,220,8696000,64,3272000,156,5424000,Fulton County,Fulton County-Essex County-NJ
3919,Fulton County-Bronx County-NY-1920,"Bronx County, NY",1920,2019,2020,187,4269000,63,1759000,124,2510000,Fulton County,Fulton County-Bronx County-NY
3920,Fulton County-Cuyahoga County-OH-1920,"Cuyahoga County, OH",1920,2019,2020,196,8265000,112,5431000,84,2834000,Fulton County,Fulton County-Cuyahoga County-OH
3921,Fulton County-Richland County-SC-1920,"Richland County, SC",1920,2019,2020,166,8232000,117,3100000,49,5132000,Fulton County,Fulton County-Richland County-SC
3922,Fulton County-Orange County-CA-1920,"Orange County, CA",1920,2019,2020,211,12637000,185,11036000,26,1601000,Fulton County,Fulton County-Orange County-CA
3923,Fulton County-Denver County-CO-1920,"Denver County, CO",1920,2019,2020,131,8334000,199,17569000,-68,-9235000,Fulton County,Fulton County-Denver County-CO
3924,Fulton County-Tarrant County-TX-1920,"Tarrant County, TX",1920,2019,2020,180,8318000,163,8695000,17,-377000,Fulton County,Fulton County-Tarrant County-TX
3925,Fulton County-Montgomery County-AL-1920,"Montgomery County, AL",1920,2019,2020,181,5099000,85,2300000,96,2799000,Fulton County,Fulton County-Montgomery County-AL
3926,Fulton County-Nassau County-NY-1920,"Nassau County, NY",1920,2019,2020,167,7072000,50,2049000,117,5023000,Fulton County,Fulton County-Nassau County-NY
3927,Fulton County-Seminole County-FL-1920,"Seminole County, FL",1920,2019,2020,161,6795000,94,4184000,67,2611000,Fulton County,Fulton County-Seminole County-FL
3928,Fulton County-Greenville County-SC-1920,"Greenville County, SC",1920,2019,2020,154,7764000,147,11567000,7,-3803000,Fulton County,Fulton County-Greenville County-SC
3929,Fulton County-Hamilton County-OH-1920,"Hamilton County, OH",1920,2019,2020,150,9039000,79,4957000,71,4082000,Fulton County,Fulton County-Hamilton County-OH
3930,Fulton County-Hamilton County-TN-1920,"Hamilton County, TN",1920,2019,2020,160,7712000,175,15067000,-15,-7355000,Fulton County,Fulton County-Hamilton County-TN
3931,Fulton County-Houston County-GA-1920,"Houston County, GA",1920,2019,2020,155,4777000,149,3474000,6,1303000,Fulton County,Fulton County-Houston County-GA
3932,Fulton County-Knox County-TN-1920,"Knox County, TN",1920,2019,2020,141,4880000,104,6937000,37,-2057000,Fulton County,Fulton County-Knox County-TN
3933,Fulton County-Bartow County-GA-1920,"Bartow County, GA",1920,2019,2020,133,4769000,179,6052000,-46,-1283000,Fulton County,Fulton County-Bartow County-GA
3934,Fulton County-Collin County-TX-1920,"Collin County, TX",1920,2019,2020,179,9997000,271,16122000,-92,-6125000,Fulton County,Fulton County-Collin County-TX
3935,Fulton County-Orleans Parish-LA-1920,"Orleans Parish, LA",1920,2019,2020,141,6799000,107,3495000,34,3304000,Fulton County,Fulton County-Orleans Parish-LA
3936,Fulton County-Alachua County-FL-1920,"Alachua County, FL",1920,2019,2020,117,5470000,49,2288000,68,3182000,Fulton County,Fulton County-Alachua County-FL
3937,Fulton County-Baltimore city-MD-1920,"Baltimore city, MD",1920,2019,2020,134,5857000,108,6172000,26,-315000,Fulton County,Fulton County-Baltimore city-MD
3938,Fulton County-Fairfield County-CT-1920,"Fairfield County, CT",1920,2019,2020,185,15941000,45,3036000,140,12905000,Fulton County,Fulton County-Fairfield County-CT
3939,Fulton County-Spalding County-GA-1920,"Spalding County, GA",1920,2019,2020,134,3528000,237,6902000,-103,-3374000,Fulton County,Fulton County-Spalding County-GA
3940,Fulton County-St. Louis County-MO-1920,"St. Louis County, MO",1920,2019,2020,161,8366000,148,9776000,13,-1410000,Fulton County,Fulton County-St. Louis County-MO
3941,Fulton County-Middlesex County-NJ-1920,"Middlesex County, NJ",1920,2019,2020,148,7186000,71,2974000,77,4212000,Fulton County,Fulton County-Middlesex County-NJ
3942,Fulton County-Madison County-AL-1920,"Madison County, AL",1920,2019,2020,120,5051000,114,5219000,6,-168000,Fulton County,Fulton County-Madison County-AL
3943,Fulton County-Walton County-GA-1920,"Walton County, GA",1920,2019,2020,139,3201000,164,7450000,-25,-4249000,Fulton County,Fulton County-Walton County-GA
3944,Fulton County-Marion County-IN-1920,"Marion County, IN",1920,2019,2020,122,4919000,102,3514000,20,1405000,Fulton County,Fulton County-Marion County-IN
3945,Fulton County-Durham County-NC-1920,"Durham County, NC",1920,2019,2020,116,6144000,101,6307000,15,-163000,Fulton County,Fulton County-Durham County-NC
3946,Fulton County-Arlington County-VA-1920,"Arlington County, VA",1920,2019,2020,91,8161000,85,7071000,6,1090000,Fulton County,Fulton County-Arlington County-VA
3947,Fulton County-Lee County-AL-1920,"Lee County, AL",1920,2019,2020,111,4622000,80,3628000,31,994000,Fulton County,Fulton County-Lee County-AL
3948,Fulton County-Milwaukee County-WI-1920,"Milwaukee County, WI",1920,2019,2020,131,6039000,53,1594000,78,4445000,Fulton County,Fulton County-Milwaukee County-WI
3949,Fulton County-Westchester County-NY-1920,"Westchester County, NY",1920,2019,2020,138,16868000,40,2627000,98,14241000,Fulton County,Fulton County-Westchester County-NY
3950,Fulton County-Dougherty County-GA-1920,"Dougherty County, GA",1920,2019,2020,132,3823000,80,1487000,52,2336000,Fulton County,Fulton County-Dougherty County-GA
3951,Fulton County-Guilford County-NC-1920,"Guilford County, NC",1920,2019,2020,115,3371000,82,3305000,33,66000,Fulton County,Fulton County-Guilford County-NC
3952,Fulton County-Contra Costa County-CA-1920,"Contra Costa County, CA",1920,2019,2020,122,6774000,38,1883000,84,4891000,Fulton County,Fulton County-Contra Costa County-CA
3953,Fulton County-Troup County-GA-1920,"Troup County, GA",1920,2019,2020,109,2901000,107,2083000,2,818000,Fulton County,Fulton County-Troup County-GA
3954,Fulton County-Baltimore County-MD-1920,"Baltimore County, MD",1920,2019,2020,131,4812000,67,3331000,64,1481000,Fulton County,Fulton County-Baltimore County-MD
3955,Fulton County-Bexar County-TX-1920,"Bexar County, TX",1920,2019,2020,140,4852000,128,6917000,12,-2065000,Fulton County,Fulton County-Bexar County-TX
3956,Fulton County-Lee County-FL-1920,"Lee County, FL",1920,2019,2020,110,7531000,128,18137000,-18,-10606000,Fulton County,Fulton County-Lee County-FL
3957,Fulton County-Escambia County-FL-1920,"Escambia County, FL",1920,2019,2020,99,5778000,93,13143000,6,-7365000,Fulton County,Fulton County-Escambia County-FL
3958,Fulton County-Riverside County-CA-1920,"Riverside County, CA",1920,2019,2020,121,4159000,87,3082000,34,1077000,Fulton County,Fulton County-Riverside County-CA
3959,Fulton County-Columbia County-GA-1920,"Columbia County, GA",1920,2019,2020,106,5258000,93,3982000,13,1276000,Fulton County,Fulton County-Columbia County-GA
3960,Fulton County-Bergen County-NJ-1920,"Bergen County, NJ",1920,2019,2020,138,13423000,65,3360000,73,10063000,Fulton County,Fulton County-Bergen County-NJ
3961,Fulton County-Suffolk County-NY-1920,"Suffolk County, NY",1920,2019,2020,116,4652000,35,2295000,81,2357000,Fulton County,Fulton County-Suffolk County-NY
3962,Fulton County-Mobile County-AL-1920,"Mobile County, AL",1920,2019,2020,113,3006000,67,2168000,46,838000,Fulton County,Fulton County-Mobile County-AL
3963,Fulton County-Brevard County-FL-1920,"Brevard County, FL",1920,2019,2020,107,5630000,108,8551000,-1,-2921000,Fulton County,Fulton County-Brevard County-FL
3964,Fulton County-Barrow County-GA-1920,"Barrow County, GA",1920,2019,2020,104,2818000,143,5597000,-39,-2779000,Fulton County,Fulton County-Barrow County-GA
3965,Fulton County-Hartford County-CT-1920,"Hartford County, CT",1920,2019,2020,118,8165000,73,4864000,45,3301000,Fulton County,Fulton County-Hartford County-CT
3966,Fulton County-Beaufort County-SC-1920,"Beaufort County, SC",1920,2019,2020,88,12290000,188,28322000,-100,-16032000,Fulton County,Fulton County-Beaufort County-SC
3967,Fulton County-Bulloch County-GA-1920,"Bulloch County, GA",1920,2019,2020,85,1710000,43,674000,42,1036000,Fulton County,Fulton County-Bulloch County-GA
3968,Fulton County-DuPage County-IL-1920,"DuPage County, IL",1920,2019,2020,121,6667000,70,5727000,51,940000,Fulton County,Fulton County-DuPage County-IL
3969,Fulton County-Jefferson County-KY-1920,"Jefferson County, KY",1920,2019,2020,96,4043000,108,5547000,-12,-1504000,Fulton County,Fulton County-Jefferson County-KY
3970,Fulton County-East Baton Rouge Parish-LA-1920,"East Baton Rouge Parish, LA",1920,2019,2020,78,2732000,50,1739000,28,993000,Fulton County,Fulton County-East Baton Rouge Parish-LA
3971,Fulton County-Floyd County-GA-1920,"Floyd County, GA",1920,2019,2020,105,2659000,114,4825000,-9,-2166000,Fulton County,Fulton County-Floyd County-GA
3972,Fulton County-Lowndes County-GA-1920,"Lowndes County, GA",1920,2019,2020,75,2191000,60,1317000,15,874000,Fulton County,Fulton County-Lowndes County-GA
3973,Fulton County-Sacramento County-CA-1920,"Sacramento County, CA",1920,2019,2020,92,3293000,53,2696000,39,597000,Fulton County,Fulton County-Sacramento County-CA
3974,Fulton County-New Haven County-CT-1920,"New Haven County, CT",1920,2019,2020,89,4164000,54,2287000,35,1877000,Fulton County,Fulton County-New Haven County-CT
3975,Fulton County-Norfolk County-MA-1920,"Norfolk County, MA",1920,2019,2020,94,5580000,43,3136000,51,2444000,Fulton County,Fulton County-Norfolk County-MA
3976,Fulton County-Jackson County-MO-1920,"Jackson County, MO",1920,2019,2020,97,4551000,52,2490000,45,2061000,Fulton County,Fulton County-Jackson County-MO
3977,Fulton County-Denton County-TX-1920,"Denton County, TX",1920,2019,2020,111,5845000,113,7327000,-2,-1482000,Fulton County,Fulton County-Denton County-TX
3978,Fulton County-Salt Lake County-UT-1920,"Salt Lake County, UT",1920,2019,2020,76,4095000,86,5270000,-10,-1175000,Fulton County,Fulton County-Salt Lake County-UT
3979,Fulton County-San Bernardino County-CA-1920,"San Bernardino County, CA",1920,2019,2020,85,2927000,38,1106000,47,1821000,Fulton County,Fulton County-San Bernardino County-CA
3980,Fulton County-Arapahoe County-CO-1920,"Arapahoe County, CO",1920,2019,2020,76,3701000,68,5956000,8,-2255000,Fulton County,Fulton County-Arapahoe County-CO
3981,Fulton County-Dane County-WI-1920,"Dane County, WI",1920,2019,2020,79,3531000,40,2008000,39,1523000,Fulton County,Fulton County-Dane County-WI
3982,Fulton County-Erie County-NY-1920,"Erie County, NY",1920,2019,2020,76,1938000,59,1576000,17,362000,Fulton County,Fulton County-Erie County-NY
3983,Fulton County-Virginia Beach city-VA-1920,"Virginia Beach city, VA",1920,2019,2020,90,6413000,56,1571000,34,4842000,Fulton County,Fulton County-Virginia Beach city-VA
3984,Fulton County-San Mateo County-CA-1920,"San Mateo County, CA",1920,2019,2020,89,13408000,78,5467000,11,7941000,Fulton County,Fulton County-San Mateo County-CA
3985,Fulton County-New Castle County-DE-1920,"New Castle County, DE",1920,2019,2020,81,3962000,51,1755000,30,2207000,Fulton County,Fulton County-New Castle County-DE
3986,Fulton County-Loudoun County-VA-1920,"Loudoun County, VA",1920,2019,2020,94,5413000,61,3608000,33,1805000,Fulton County,Fulton County-Loudoun County-VA
3987,Fulton County-Volusia County-FL-1920,"Volusia County, FL",1920,2019,2020,68,1861000,90,5426000,-22,-3565000,Fulton County,Fulton County-Volusia County-FL
3988,Fulton County-Shelby County-AL-1920,"Shelby County, AL",1920,2019,2020,90,4035000,74,3786000,16,249000,Fulton County,Fulton County-Shelby County-AL
3989,Fulton County-Sarasota County-FL-1920,"Sarasota County, FL",1920,2019,2020,71,4556000,141,24647000,-70,-20091000,Fulton County,Fulton County-Sarasota County-FL
3990,Fulton County-Glynn County-GA-1920,"Glynn County, GA",1920,2019,2020,76,22284000,180,18944000,-104,3340000,Fulton County,Fulton County-Glynn County-GA
3991,Fulton County-Fayette County-KY-1920,"Fayette County, KY",1920,2019,2020,77,4747000,23,1356000,54,3391000,Fulton County,Fulton County-Fayette County-KY
3992,Fulton County-Fort Bend County-TX-1920,"Fort Bend County, TX",1920,2019,2020,125,6433000,73,3333000,52,3100000,Fulton County,Fulton County-Fort Bend County-TX
3993,Fulton County-Jackson County-GA-1920,"Jackson County, GA",1920,2019,2020,75,2077000,106,4287000,-31,-2210000,Fulton County,Fulton County-Jackson County-GA
3994,Fulton County-Washtenaw County-MI-1920,"Washtenaw County, MI",1920,2019,2020,65,4794000,43,2525000,22,2269000,Fulton County,Fulton County-Washtenaw County-MI
3995,Fulton County-Tuscaloosa County-AL-1920,"Tuscaloosa County, AL",1920,2019,2020,68,2394000,41,1389000,27,1005000,Fulton County,Fulton County-Tuscaloosa County-AL
3996,Fulton County-Multnomah County-OR-1920,"Multnomah County, OR",1920,2019,2020,55,4561000,79,5288000,-24,-727000,Fulton County,Fulton County-Multnomah County-OR
3997,Fulton County-Hinds County-MS-1920,"Hinds County, MS",1920,2019,2020,75,1821000,43,972000,32,849000,Fulton County,Fulton County-Hinds County-MS
3998,Fulton County-Alexandria city-VA-1920,"Alexandria city, VA",1920,2019,2020,61,5082000,36,2449000,25,2633000,Fulton County,Fulton County-Alexandria city-VA
3999,Fulton County-Manatee County-FL-1920,"Manatee County, FL",1920,2019,2020,61,3410000,101,7083000,-40,-3673000,Fulton County,Fulton County-Manatee County-FL
4000,Fulton County-Polk County-FL-1920,"Polk County, FL",1920,2019,2020,63,2362000,67,1773000,-4,589000,Fulton County,Fulton County-Polk County-FL
4001,Fulton County-St. Louis city-MO-1920,"St. Louis city, MO",1920,2019,2020,72,4018000,51,1277000,21,2741000,Fulton County,Fulton County-St. Louis city-MO
4002,Fulton County-Cumberland County-NC-1920,"Cumberland County, NC",1920,2019,2020,72,1932000,55,1236000,17,696000,Fulton County,Fulton County-Cumberland County-NC
4003,Fulton County-Henrico County-VA-1920,"Henrico County, VA",1920,2019,2020,67,4199000,56,3093000,11,1106000,Fulton County,Fulton County-Henrico County-VA
4004,Fulton County-Prince William County-VA-1920,"Prince William County, VA",1920,2019,2020,59,2147000,53,2007000,6,140000,Fulton County,Fulton County-Prince William County-VA
4005,Fulton County-Montgomery County-OH-1920,"Montgomery County, OH",1920,2019,2020,79,1657000,41,1379000,38,278000,Fulton County,Fulton County-Montgomery County-OH
4006,Fulton County-Williamson County-TN-1920,"Williamson County, TN",1920,2019,2020,66,3203000,116,10386000,-50,-7183000,Fulton County,Fulton County-Williamson County-TN
4007,Fulton County-Forsyth County-NC-1920,"Forsyth County, NC",1920,2019,2020,62,3267000,54,4285000,8,-1018000,Fulton County,Fulton County-Forsyth County-NC
4008,Fulton County-St. Johns County-FL-1920,"St. Johns County, FL",1920,2019,2020,58,2453000,188,21476000,-130,-19023000,Fulton County,Fulton County-St. Johns County-FL
4009,Fulton County-Liberty County-GA-1920,"Liberty County, GA",1920,2019,2020,57,1074000,59,1314000,-2,-240000,Fulton County,Fulton County-Liberty County-GA
4010,Fulton County-Monroe County-NY-1920,"Monroe County, NY",1920,2019,2020,66,2228000,43,2268000,23,-40000,Fulton County,Fulton County-Monroe County-NY
4011,Fulton County-Richmond city-VA-1920,"Richmond city, VA",1920,2019,2020,52,3043000,65,3699000,-13,-656000,Fulton County,Fulton County-Richmond city-VA
4012,Fulton County-Oconee County-GA-1920,"Oconee County, GA",1920,2019,2020,62,2850000,73,5765000,-11,-2915000,Fulton County,Fulton County-Oconee County-GA
4013,Fulton County-Honolulu County-HI-1920,"Honolulu County, HI",1920,2019,2020,54,2224000,63,2503000,-9,-279000,Fulton County,Fulton County-Honolulu County-HI
4014,Fulton County-Montgomery County-PA-1920,"Montgomery County, PA",1920,2019,2020,62,4131000,46,3919000,16,212000,Fulton County,Fulton County-Montgomery County-PA
4015,Fulton County-Collier County-FL-1920,"Collier County, FL",1920,2019,2020,61,14001000,85,39098000,-24,-25097000,Fulton County,Fulton County-Collier County-FL
4016,Fulton County-Pasco County-FL-1920,"Pasco County, FL",1920,2019,2020,62,2503000,90,3957000,-28,-1454000,Fulton County,Fulton County-Pasco County-FL
4017,Fulton County-Dawson County-GA-1920,"Dawson County, GA",1920,2019,2020,63,2638000,195,18791000,-132,-16153000,Fulton County,Fulton County-Dawson County-GA
4018,Fulton County-Anne Arundel County-MD-1920,"Anne Arundel County, MD",1920,2019,2020,59,2840000,65,2537000,-6,303000,Fulton County,Fulton County-Anne Arundel County-MD
4019,Fulton County-Kent County-MI-1920,"Kent County, MI",1920,2019,2020,59,2352000,46,2375000,13,-23000,Fulton County,Fulton County-Kent County-MI
4020,Fulton County-Douglas County-NE-1920,"Douglas County, NE",1920,2019,2020,74,2744000,52,2316000,22,428000,Fulton County,Fulton County-Douglas County-NE
4021,Fulton County-Bernalillo County-NM-1920,"Bernalillo County, NM",1920,2019,2020,50,2293000,42,2462000,8,-169000,Fulton County,Fulton County-Bernalillo County-NM
4022,Fulton County-Lexington County-SC-1920,"Lexington County, SC",1920,2019,2020,57,1851000,37,867000,20,984000,Fulton County,Fulton County-Lexington County-SC
4023,Fulton County-Walton County-FL-1920,"Walton County, FL",1920,2019,2020,61,14843000,151,53149000,-90,-38306000,Fulton County,Fulton County-Walton County-FL
4024,Fulton County-Pickens County-GA-1920,"Pickens County, GA",1920,2019,2020,46,3178000,153,13187000,-107,-10009000,Fulton County,Fulton County-Pickens County-GA
4025,Fulton County-Aiken County-SC-1920,"Aiken County, SC",1920,2019,2020,57,1660000,32,2219000,25,-559000,Fulton County,Fulton County-Aiken County-SC
4026,Fulton County-Berkeley County-SC-1920,"Berkeley County, SC",1920,2019,2020,56,2623000,36,1419000,20,1204000,Fulton County,Fulton County-Berkeley County-SC
4027,Fulton County-Norfolk city-VA-1920,"Norfolk city, VA",1920,2019,2020,64,2279000,29,1757000,35,522000,Fulton County,Fulton County-Norfolk city-VA
4028,Fulton County-Pulaski County-AR-1920,"Pulaski County, AR",1920,2019,2020,59,1545000,56,1671000,3,-126000,Fulton County,Fulton County-Pulaski County-AR
4029,Fulton County-Buncombe County-NC-1920,"Buncombe County, NC",1920,2019,2020,39,1737000,85,7977000,-46,-6240000,Fulton County,Fulton County-Buncombe County-NC
4030,Fulton County-Rutherford County-TN-1920,"Rutherford County, TN",1920,2019,2020,45,1753000,59,2267000,-14,-514000,Fulton County,Fulton County-Rutherford County-TN
4031,Fulton County-Union County-NJ-1920,"Union County, NJ",1920,2019,2020,59,4739000,34,1469000,25,3270000,Fulton County,Fulton County-Union County-NJ
4032,Fulton County-Horry County-SC-1920,"Horry County, SC",1920,2019,2020,49,1673000,48,2538000,1,-865000,Fulton County,Fulton County-Horry County-SC
4033,Fulton County-Spartanburg County-SC-1920,"Spartanburg County, SC",1920,2019,2020,41,1887000,72,2979000,-31,-1092000,Fulton County,Fulton County-Spartanburg County-SC
4034,Fulton County-Whitfield County-GA-1920,"Whitfield County, GA",1920,2019,2020,37,1573000,36,1259000,1,314000,Fulton County,Fulton County-Whitfield County-GA
4035,Fulton County-Johnson County-KS-1920,"Johnson County, KS",1920,2019,2020,50,2268000,58,2261000,-8,7000,Fulton County,Fulton County-Johnson County-KS
4036,Fulton County-Jefferson Parish-LA-1920,"Jefferson Parish, LA",1920,2019,2020,46,1363000,48,2425000,-2,-1062000,Fulton County,Fulton County-Jefferson Parish-LA
4037,Fulton County-Onondaga County-NY-1920,"Onondaga County, NY",1920,2019,2020,42,2216000,28,1016000,14,1200000,Fulton County,Fulton County-Onondaga County-NY
4038,Fulton County-Jefferson County-CO-1920,"Jefferson County, CO",1920,2019,2020,44,2616000,50,3783000,-6,-1167000,Fulton County,Fulton County-Jefferson County-CO
4039,Fulton County-Bay County-FL-1920,"Bay County, FL",1920,2019,2020,42,2106000,61,6974000,-19,-4868000,Fulton County,Fulton County-Bay County-FL
4040,Fulton County-Osceola County-FL-1920,"Osceola County, FL",1920,2019,2020,46,1226000,51,3699000,-5,-2473000,Fulton County,Fulton County-Osceola County-FL
4041,Fulton County-Lumpkin County-GA-1920,"Lumpkin County, GA",1920,2019,2020,40,1428000,84,6078000,-44,-4650000,Fulton County,Fulton County-Lumpkin County-GA
4042,Fulton County-Lake County-IL-1920,"Lake County, IL",1920,2019,2020,75,4719000,59,4981000,16,-262000,Fulton County,Fulton County-Lake County-IL
4043,Fulton County-Lake County-FL-1920,"Lake County, FL",1920,2019,2020,72,1971000,35,1707000,37,264000,Fulton County,Fulton County-Lake County-FL
4044,Fulton County-St. Lucie County-FL-1920,"St. Lucie County, FL",1920,2019,2020,41,1133000,42,1967000,-1,-834000,Fulton County,Fulton County-St. Lucie County-FL
4045,Fulton County-Hamilton County-IN-1920,"Hamilton County, IN",1920,2019,2020,47,2791000,57,3144000,-10,-353000,Fulton County,Fulton County-Hamilton County-IN
4046,Fulton County-Williamson County-TX-1920,"Williamson County, TX",1920,2019,2020,61,2438000,81,3501000,-20,-1063000,Fulton County,Fulton County-Williamson County-TX
4047,Fulton County-El Paso County-CO-1920,"El Paso County, CO",1920,2019,2020,57,2358000,73,3384000,-16,-1026000,Fulton County,Fulton County-El Paso County-CO
4048,Fulton County-Essex County-MA-1920,"Essex County, MA",1920,2019,2020,47,2759000,40,2862000,7,-103000,Fulton County,Fulton County-Essex County-MA
4049,Fulton County-Chester County-PA-1920,"Chester County, PA",1920,2019,2020,51,2494000,40,2167000,11,327000,Fulton County,Fulton County-Chester County-PA
4050,Fulton County-York County-SC-1920,"York County, SC",1920,2019,2020,44,2750000,55,3496000,-11,-746000,Fulton County,Fulton County-York County-SC
4051,Fulton County-Okaloosa County-FL-1920,"Okaloosa County, FL",1920,2019,2020,42,2183000,44,3131000,-2,-948000,Fulton County,Fulton County-Okaloosa County-FL
4052,Fulton County-Howard County-MD-1920,"Howard County, MD",1920,2019,2020,55,3495000,39,2364000,16,1131000,Fulton County,Fulton County-Howard County-MD
4053,Fulton County-Summit County-OH-1920,"Summit County, OH",1920,2019,2020,40,1846000,34,1274000,6,572000,Fulton County,Fulton County-Summit County-OH
4054,Fulton County-Baldwin County-GA-1920,"Baldwin County, GA",1920,2019,2020,29,858000,40,2051000,-11,-1193000,Fulton County,Fulton County-Baldwin County-GA
4055,Fulton County-New Hanover County-NC-1920,"New Hanover County, NC",1920,2019,2020,44,1383000,58,2651000,-14,-1268000,Fulton County,Fulton County-New Hanover County-NC
4056,Fulton County-Montgomery County-TN-1920,"Montgomery County, TN",1920,2019,2020,40,1005000,31,952000,9,53000,Fulton County,Fulton County-Montgomery County-TN
4057,Fulton County-Montgomery County-TX-1920,"Montgomery County, TX",1920,2019,2020,40,2690000,39,5407000,1,-2717000,Fulton County,Fulton County-Montgomery County-TX
4058,Fulton County-Pima County-AZ-1920,"Pima County, AZ",1920,2019,2020,31,1595000,67,3936000,-36,-2341000,Fulton County,Fulton County-Pima County-AZ
4059,Fulton County-Douglas County-CO-1920,"Douglas County, CO",1920,2019,2020,52,2910000,67,4608000,-15,-1698000,Fulton County,Fulton County-Douglas County-CO
4060,Fulton County-Clay County-FL-1920,"Clay County, FL",1920,2019,2020,39,994000,36,1694000,3,-700000,Fulton County,Fulton County-Clay County-FL
4061,Fulton County-Gilmer County-GA-1920,"Gilmer County, GA",1920,2019,2020,38,904000,82,7020000,-44,-6116000,Fulton County,Fulton County-Gilmer County-GA
4062,Fulton County-Warren County-OH-1920,"Warren County, OH",1920,2019,2020,47,3991000,48,3202000,-1,789000,Fulton County,Fulton County-Warren County-OH
4063,Fulton County-Providence County-RI-1920,"Providence County, RI",1920,2019,2020,33,1094000,31,1849000,2,-755000,Fulton County,Fulton County-Providence County-RI
4064,Fulton County-Snohomish County-WA-1920,"Snohomish County, WA",1920,2019,2020,44,2967000,36,1927000,8,1040000,Fulton County,Fulton County-Snohomish County-WA
4065,Fulton County-Greene County-GA-1920,"Greene County, GA",1920,2019,2020,38,1650000,144,28602000,-106,-26952000,Fulton County,Fulton County-Greene County-GA
4066,Fulton County-Macomb County-MI-1920,"Macomb County, MI",1920,2019,2020,41,1110000,33,711000,8,399000,Fulton County,Fulton County-Macomb County-MI
4068,Gwinnett County-DeKalb County-GA-1920,"DeKalb County, GA",1920,2019,2020,12247,273895000,7944,205329000,4303,68566000,Gwinnett County,Gwinnett County-DeKalb County-GA
4069,Gwinnett County-Fulton County-GA-1920,"Fulton County, GA",1920,2019,2020,6565,232753000,6012,248248000,553,-15495000,Gwinnett County,Gwinnett County-Fulton County-GA
4070,Gwinnett County-Cobb County-GA-1920,"Cobb County, GA",1920,2019,2020,2192,60089000,2090,64320000,102,-4231000,Gwinnett County,Gwinnett County-Cobb County-GA
4071,Gwinnett County-Forsyth County-GA-1920,"Forsyth County, GA",1920,2019,2020,1644,60478000,2527,102955000,-883,-42477000,Gwinnett County,Gwinnett County-Forsyth County-GA
4072,Gwinnett County-Hall County-GA-1920,"Hall County, GA",1920,2019,2020,1568,46450000,3844,150485000,-2276,-104035000,Gwinnett County,Gwinnett County-Hall County-GA
4073,Gwinnett County-Barrow County-GA-1920,"Barrow County, GA",1920,2019,2020,1385,33251000,3049,76562000,-1664,-43311000,Gwinnett County,Gwinnett County-Barrow County-GA
4074,Gwinnett County-Walton County-GA-1920,"Walton County, GA",1920,2019,2020,1294,29248000,3152,87300000,-1858,-58052000,Gwinnett County,Gwinnett County-Walton County-GA
4075,Gwinnett County-Clayton County-GA-1920,"Clayton County, GA",1920,2019,2020,923,14071000,836,11881000,87,2190000,Gwinnett County,Gwinnett County-Clayton County-GA
4076,Gwinnett County-Henry County-GA-1920,"Henry County, GA",1920,2019,2020,688,14558000,714,17043000,-26,-2485000,Gwinnett County,Gwinnett County-Henry County-GA
4077,Gwinnett County-Broward County-FL-1920,"Broward County, FL",1920,2019,2020,672,14994000,253,10145000,419,4849000,Gwinnett County,Gwinnett County-Broward County-FL
4078,Gwinnett County-Los Angeles County-CA-1920,"Los Angeles County, CA",1920,2019,2020,588,20575000,295,7686000,293,12889000,Gwinnett County,Gwinnett County-Los Angeles County-CA
4079,Gwinnett County-Rockdale County-GA-1920,"Rockdale County, GA",1920,2019,2020,644,13296000,819,15221000,-175,-1925000,Gwinnett County,Gwinnett County-Rockdale County-GA
4080,Gwinnett County-Miami-Dade County-FL-1920,"Miami-Dade County, FL",1920,2019,2020,614,10193000,297,7344000,317,2849000,Gwinnett County,Gwinnett County-Miami-Dade County-FL
4081,Gwinnett County-Clarke County-GA-1920,"Clarke County, GA",1920,2019,2020,439,11405000,433,11908000,6,-503000,Gwinnett County,Gwinnett County-Clarke County-GA
4082,Gwinnett County-Kings County-NY-1920,"Kings County, NY",1920,2019,2020,474,14351000,131,3624000,343,10727000,Gwinnett County,Gwinnett County-Kings County-NY
4083,Gwinnett County-Cherokee County-GA-1920,"Cherokee County, GA",1920,2019,2020,444,14883000,759,27065000,-315,-12182000,Gwinnett County,Gwinnett County-Cherokee County-GA
4084,Gwinnett County-Jackson County-GA-1920,"Jackson County, GA",1920,2019,2020,484,14320000,2223,72482000,-1739,-58162000,Gwinnett County,Gwinnett County-Jackson County-GA
4085,Gwinnett County-Newton County-GA-1920,"Newton County, GA",1920,2019,2020,485,9114000,720,14687000,-235,-5573000,Gwinnett County,Gwinnett County-Newton County-GA
4086,Gwinnett County-Queens County-NY-1920,"Queens County, NY",1920,2019,2020,454,6461000,118,2739000,336,3722000,Gwinnett County,Gwinnett County-Queens County-NY
4087,Gwinnett County-Cook County-IL-1920,"Cook County, IL",1920,2019,2020,424,10932000,214,6509000,210,4423000,Gwinnett County,Gwinnett County-Cook County-IL
4088,Gwinnett County-Bronx County-NY-1920,"Bronx County, NY",1920,2019,2020,382,7311000,89,1392000,293,5919000,Gwinnett County,Gwinnett County-Bronx County-NY
4089,Gwinnett County-Orange County-FL-1920,"Orange County, FL",1920,2019,2020,315,6919000,269,7153000,46,-234000,Gwinnett County,Gwinnett County-Orange County-FL
4090,Gwinnett County-Douglas County-GA-1920,"Douglas County, GA",1920,2019,2020,350,5575000,355,7073000,-5,-1498000,Gwinnett County,Gwinnett County-Douglas County-GA
4091,Gwinnett County-Harris County-TX-1920,"Harris County, TX",1920,2019,2020,277,6291000,336,7614000,-59,-1323000,Gwinnett County,Gwinnett County-Harris County-TX
4092,Gwinnett County-Mecklenburg County-NC-1920,"Mecklenburg County, NC",1920,2019,2020,251,6690000,267,9963000,-16,-3273000,Gwinnett County,Gwinnett County-Mecklenburg County-NC
4093,Gwinnett County-Palm Beach County-FL-1920,"Palm Beach County, FL",1920,2019,2020,271,8487000,196,14009000,75,-5522000,Gwinnett County,Gwinnett County-Palm Beach County-FL
4094,Gwinnett County-Chatham County-GA-1920,"Chatham County, GA",1920,2019,2020,220,4847000,254,7309000,-34,-2462000,Gwinnett County,Gwinnett County-Chatham County-GA
4095,Gwinnett County-Duval County-FL-1920,"Duval County, FL",1920,2019,2020,270,6116000,173,5381000,97,735000,Gwinnett County,Gwinnett County-Duval County-FL
4096,Gwinnett County-Nassau County-NY-1920,"Nassau County, NY",1920,2019,2020,256,6440000,50,1541000,206,4899000,Gwinnett County,Gwinnett County-Nassau County-NY
4097,Gwinnett County-New York County-NY-1920,"New York County, NY",1920,2019,2020,173,8671000,70,3686000,103,4985000,Gwinnett County,Gwinnett County-New York County-NY
4098,Gwinnett County-Hillsborough County-FL-1920,"Hillsborough County, FL",1920,2019,2020,207,8775000,278,16740000,-71,-7965000,Gwinnett County,Gwinnett County-Hillsborough County-FL
4099,Gwinnett County-Dallas County-TX-1920,"Dallas County, TX",1920,2019,2020,180,4887000,163,6726000,17,-1839000,Gwinnett County,Gwinnett County-Dallas County-TX
4100,Gwinnett County-Muscogee County-GA-1920,"Muscogee County, GA",1920,2019,2020,216,4287000,122,2166000,94,2121000,Gwinnett County,Gwinnett County-Muscogee County-GA
4101,Gwinnett County-Orange County-CA-1920,"Orange County, CA",1920,2019,2020,227,6397000,128,3685000,99,2712000,Gwinnett County,Gwinnett County-Orange County-CA
4102,Gwinnett County-Paulding County-GA-1920,"Paulding County, GA",1920,2019,2020,193,4587000,296,6415000,-103,-1828000,Gwinnett County,Gwinnett County-Paulding County-GA
4103,Gwinnett County-Suffolk County-NY-1920,"Suffolk County, NY",1920,2019,2020,170,4701000,65,1092000,105,3609000,Gwinnett County,Gwinnett County-Suffolk County-NY
4104,Gwinnett County-Jefferson County-AL-1920,"Jefferson County, AL",1920,2019,2020,179,4459000,121,2954000,58,1505000,Gwinnett County,Gwinnett County-Jefferson County-AL
4105,Gwinnett County-Wake County-NC-1920,"Wake County, NC",1920,2019,2020,189,5847000,227,6156000,-38,-309000,Gwinnett County,Gwinnett County-Wake County-NC
4106,Gwinnett County-San Diego County-CA-1920,"San Diego County, CA",1920,2019,2020,173,5672000,114,3455000,59,2217000,Gwinnett County,Gwinnett County-San Diego County-CA
4107,Gwinnett County-Richmond County-GA-1920,"Richmond County, GA",1920,2019,2020,143,3155000,127,2689000,16,466000,Gwinnett County,Gwinnett County-Richmond County-GA
4108,Gwinnett County-Maricopa County-AZ-1920,"Maricopa County, AZ",1920,2019,2020,179,5478000,214,5673000,-35,-195000,Gwinnett County,Gwinnett County-Maricopa County-AZ
4109,Gwinnett County-Shelby County-TN-1920,"Shelby County, TN",1920,2019,2020,172,4270000,153,4716000,19,-446000,Gwinnett County,Gwinnett County-Shelby County-TN
4110,Gwinnett County-Coweta County-GA-1920,"Coweta County, GA",1920,2019,2020,195,5168000,207,6024000,-12,-856000,Gwinnett County,Gwinnett County-Coweta County-GA
4111,Gwinnett County-Prince George's County-MD-1920,"Prince George's County, MD",1920,2019,2020,181,3189000,99,2363000,82,826000,Gwinnett County,Gwinnett County-Prince George's County-MD
4112,Gwinnett County-Fayette County-GA-1920,"Fayette County, GA",1920,2019,2020,172,4745000,154,4227000,18,518000,Gwinnett County,Gwinnett County-Fayette County-GA
4113,Gwinnett County-Fairfax County-VA-1920,"Fairfax County, VA",1920,2019,2020,152,6951000,95,3695000,57,3256000,Gwinnett County,Gwinnett County-Fairfax County-VA
4114,Gwinnett County-Clark County-NV-1920,"Clark County, NV",1920,2019,2020,165,3629000,185,3380000,-20,249000,Gwinnett County,Gwinnett County-Clark County-NV
4115,Gwinnett County-Bergen County-NJ-1920,"Bergen County, NJ",1920,2019,2020,181,5008000,51,2559000,130,2449000,Gwinnett County,Gwinnett County-Bergen County-NJ
4116,Gwinnett County-Houston County-GA-1920,"Houston County, GA",1920,2019,2020,136,2794000,147,2727000,-11,67000,Gwinnett County,Gwinnett County-Houston County-GA
4117,Gwinnett County-Montgomery County-MD-1920,"Montgomery County, MD",1920,2019,2020,141,4978000,91,1838000,50,3140000,Gwinnett County,Gwinnett County-Montgomery County-MD
4118,Gwinnett County-Bibb County-GA-1920,"Bibb County, GA",1920,2019,2020,140,3417000,116,3497000,24,-80000,Gwinnett County,Gwinnett County-Bibb County-GA
4119,Gwinnett County-Davidson County-TN-1920,"Davidson County, TN",1920,2019,2020,125,3106000,123,3844000,2,-738000,Gwinnett County,Gwinnett County-Davidson County-TN
4120,Gwinnett County-Pinellas County-FL-1920,"Pinellas County, FL",1920,2019,2020,105,5297000,154,5899000,-49,-602000,Gwinnett County,Gwinnett County-Pinellas County-FL
4121,Gwinnett County-Cuyahoga County-OH-1920,"Cuyahoga County, OH",1920,2019,2020,184,4933000,44,676000,140,4257000,Gwinnett County,Gwinnett County-Cuyahoga County-OH
4122,Gwinnett County-Franklin County-OH-1920,"Franklin County, OH",1920,2019,2020,115,3378000,69,2110000,46,1268000,Gwinnett County,Gwinnett County-Franklin County-OH
4123,Gwinnett County-Hamilton County-TN-1920,"Hamilton County, TN",1920,2019,2020,129,3442000,113,5653000,16,-2211000,Gwinnett County,Gwinnett County-Hamilton County-TN
4124,Gwinnett County-Philadelphia County-PA-1920,"Philadelphia County, PA",1920,2019,2020,134,2427000,94,1477000,40,950000,Gwinnett County,Gwinnett County-Philadelphia County-PA
4125,Gwinnett County-Tarrant County-TX-1920,"Tarrant County, TX",1920,2019,2020,128,3622000,183,5390000,-55,-1768000,Gwinnett County,Gwinnett County-Tarrant County-TX
4126,Gwinnett County-Greenville County-SC-1920,"Greenville County, SC",1920,2019,2020,124,3382000,177,6777000,-53,-3395000,Gwinnett County,Gwinnett County-Greenville County-SC
4127,Gwinnett County-Essex County-NJ-1920,"Essex County, NJ",1920,2019,2020,112,2651000,40,1375000,72,1276000,Gwinnett County,Gwinnett County-Essex County-NJ
4128,Gwinnett County-King County-WA-1920,"King County, WA",1920,2019,2020,143,5704000,123,7668000,20,-1964000,Gwinnett County,Gwinnett County-King County-WA
4129,Gwinnett County-Montgomery County-AL-1920,"Montgomery County, AL",1920,2019,2020,137,4516000,60,1605000,77,2911000,Gwinnett County,Gwinnett County-Montgomery County-AL
4130,Gwinnett County-Westchester County-NY-1920,"Westchester County, NY",1920,2019,2020,122,2837000,37,546000,85,2291000,Gwinnett County,Gwinnett County-Westchester County-NY
4131,Gwinnett County-Hudson County-NJ-1920,"Hudson County, NJ",1920,2019,2020,116,4082000,26,943000,90,3139000,Gwinnett County,Gwinnett County-Hudson County-NJ
4132,Gwinnett County-Wayne County-MI-1920,"Wayne County, MI",1920,2019,2020,115,2623000,73,1305000,42,1318000,Gwinnett County,Gwinnett County-Wayne County-MI
4133,Gwinnett County-Richland County-SC-1920,"Richland County, SC",1920,2019,2020,121,2883000,107,2196000,14,687000,Gwinnett County,Gwinnett County-Richland County-SC
4134,Gwinnett County-Lowndes County-GA-1920,"Lowndes County, GA",1920,2019,2020,92,2389000,65,1303000,27,1086000,Gwinnett County,Gwinnett County-Lowndes County-GA
4135,Gwinnett County-Leon County-FL-1920,"Leon County, FL",1920,2019,2020,76,2167000,47,1364000,29,803000,Gwinnett County,Gwinnett County-Leon County-FL
4136,Gwinnett County-Middlesex County-NJ-1920,"Middlesex County, NJ",1920,2019,2020,129,2999000,76,1251000,53,1748000,Gwinnett County,Gwinnett County-Middlesex County-NJ
4137,Gwinnett County-Milwaukee County-WI-1920,"Milwaukee County, WI",1920,2019,2020,122,2083000,44,494000,78,1589000,Gwinnett County,Gwinnett County-Milwaukee County-WI
4138,Gwinnett County-Dougherty County-GA-1920,"Dougherty County, GA",1920,2019,2020,99,1572000,45,693000,54,879000,Gwinnett County,Gwinnett County-Dougherty County-GA
4139,Gwinnett County-Bexar County-TX-1920,"Bexar County, TX",1920,2019,2020,125,2708000,89,2580000,36,128000,Gwinnett County,Gwinnett County-Bexar County-TX
4140,Gwinnett County-Carroll County-GA-1920,"Carroll County, GA",1920,2019,2020,95,3149000,105,2513000,-10,636000,Gwinnett County,Gwinnett County-Carroll County-GA
4141,Gwinnett County-Seminole County-FL-1920,"Seminole County, FL",1920,2019,2020,109,1905000,95,2139000,14,-234000,Gwinnett County,Gwinnett County-Seminole County-FL
4142,Gwinnett County-Alameda County-CA-1920,"Alameda County, CA",1920,2019,2020,106,5007000,85,3383000,21,1624000,Gwinnett County,Gwinnett County-Alameda County-CA
4143,Gwinnett County-Lee County-FL-1920,"Lee County, FL",1920,2019,2020,94,2844000,105,5521000,-11,-2677000,Gwinnett County,Gwinnett County-Lee County-FL
4144,Gwinnett County-Polk County-FL-1920,"Polk County, FL",1920,2019,2020,136,3120000,121,2297000,15,823000,Gwinnett County,Gwinnett County-Polk County-FL
4145,Gwinnett County-Volusia County-FL-1920,"Volusia County, FL",1920,2019,2020,84,1814000,107,4424000,-23,-2610000,Gwinnett County,Gwinnett County-Volusia County-FL
4146,Gwinnett County-Oakland County-MI-1920,"Oakland County, MI",1920,2019,2020,110,3556000,34,740000,76,2816000,Gwinnett County,Gwinnett County-Oakland County-MI
4147,Gwinnett County-Columbia County-GA-1920,"Columbia County, GA",1920,2019,2020,123,2355000,167,3240000,-44,-885000,Gwinnett County,Gwinnett County-Columbia County-GA
4148,Gwinnett County-Collin County-TX-1920,"Collin County, TX",1920,2019,2020,115,5891000,142,4100000,-27,1791000,Gwinnett County,Gwinnett County-Collin County-TX
4149,Gwinnett County-Riverside County-CA-1920,"Riverside County, CA",1920,2019,2020,96,2052000,79,2410000,17,-358000,Gwinnett County,Gwinnett County-Riverside County-CA
4150,Gwinnett County-Honolulu County-HI-1920,"Honolulu County, HI",1920,2019,2020,110,2675000,61,1842000,49,833000,Gwinnett County,Gwinnett County-Honolulu County-HI
4151,Gwinnett County-Marion County-IN-1920,"Marion County, IN",1920,2019,2020,89,1673000,100,1327000,-11,346000,Gwinnett County,Gwinnett County-Marion County-IN
4152,Gwinnett County-Santa Clara County-CA-1920,"Santa Clara County, CA",1920,2019,2020,78,3406000,54,4531000,24,-1125000,Gwinnett County,Gwinnett County-Santa Clara County-CA
4153,Gwinnett County-Knox County-TN-1920,"Knox County, TN",1920,2019,2020,78,2321000,93,3431000,-15,-1110000,Gwinnett County,Gwinnett County-Knox County-TN
4154,Gwinnett County-Dawson County-GA-1920,"Dawson County, GA",1920,2019,2020,80,2613000,160,5776000,-80,-3163000,Gwinnett County,Gwinnett County-Dawson County-GA
4155,Gwinnett County-Guilford County-NC-1920,"Guilford County, NC",1920,2019,2020,92,2046000,71,2191000,21,-145000,Gwinnett County,Gwinnett County-Guilford County-NC
4156,Gwinnett County-Lee County-AL-1920,"Lee County, AL",1920,2019,2020,88,2586000,81,4126000,7,-1540000,Gwinnett County,Gwinnett County-Lee County-AL
4157,Gwinnett County-San Bernardino County-CA-1920,"San Bernardino County, CA",1920,2019,2020,141,2778000,53,1367000,88,1411000,Gwinnett County,Gwinnett County-San Bernardino County-CA
4158,Gwinnett County-Arapahoe County-CO-1920,"Arapahoe County, CO",1920,2019,2020,107,2249000,40,1570000,67,679000,Gwinnett County,Gwinnett County-Arapahoe County-CO
4159,Gwinnett County-St. Louis County-MO-1920,"St. Louis County, MO",1920,2019,2020,94,1496000,45,783000,49,713000,Gwinnett County,Gwinnett County-St. Louis County-MO
4160,Gwinnett County-Travis County-TX-1920,"Travis County, TX",1920,2019,2020,79,3159000,94,3188000,-15,-29000,Gwinnett County,Gwinnett County-Travis County-TX
4161,Gwinnett County-Prince William County-VA-1920,"Prince William County, VA",1920,2019,2020,84,2120000,40,1282000,44,838000,Gwinnett County,Gwinnett County-Prince William County-VA
4162,Gwinnett County-Madison County-AL-1920,"Madison County, AL",1920,2019,2020,61,1744000,119,3584000,-58,-1840000,Gwinnett County,Gwinnett County-Madison County-AL
4163,Gwinnett County-Baltimore County-MD-1920,"Baltimore County, MD",1920,2019,2020,99,1712000,82,1080000,17,632000,Gwinnett County,Gwinnett County-Baltimore County-MD
4164,Gwinnett County-El Paso County-CO-1920,"El Paso County, CO",1920,2019,2020,98,1935000,68,2307000,30,-372000,Gwinnett County,Gwinnett County-El Paso County-CO
4165,Gwinnett County-District of Columbia-DC-1920,"District of Columbia, DC",1920,2019,2020,59,2489000,52,1984000,7,505000,Gwinnett County,Gwinnett County-District of Columbia-DC
4166,Gwinnett County-Habersham County-GA-1920,"Habersham County, GA",1920,2019,2020,58,1886000,176,6387000,-118,-4501000,Gwinnett County,Gwinnett County-Habersham County-GA
4167,Gwinnett County-Oconee County-GA-1920,"Oconee County, GA",1920,2019,2020,75,2648000,320,14380000,-245,-11732000,Gwinnett County,Gwinnett County-Oconee County-GA
4168,Gwinnett County-Middlesex County-MA-1920,"Middlesex County, MA",1920,2019,2020,77,3272000,50,2623000,27,649000,Gwinnett County,Gwinnett County-Middlesex County-MA
4169,Gwinnett County-Cumberland County-NC-1920,"Cumberland County, NC",1920,2019,2020,88,2017000,53,935000,35,1082000,Gwinnett County,Gwinnett County-Cumberland County-NC
4170,Gwinnett County-Mobile County-AL-1920,"Mobile County, AL",1920,2019,2020,93,1671000,59,1454000,34,217000,Gwinnett County,Gwinnett County-Mobile County-AL
4171,Gwinnett County-White County-GA-1920,"White County, GA",1920,2019,2020,69,2407000,144,4768000,-75,-2361000,Gwinnett County,Gwinnett County-White County-GA
4172,Gwinnett County-Charleston County-SC-1920,"Charleston County, SC",1920,2019,2020,65,1509000,88,3803000,-23,-2294000,Gwinnett County,Gwinnett County-Charleston County-SC
4173,Gwinnett County-Alachua County-FL-1920,"Alachua County, FL",1920,2019,2020,63,2387000,51,1726000,12,661000,Gwinnett County,Gwinnett County-Alachua County-FL
4174,Gwinnett County-Shelby County-AL-1920,"Shelby County, AL",1920,2019,2020,67,2277000,73,2895000,-6,-618000,Gwinnett County,Gwinnett County-Shelby County-AL
4175,Gwinnett County-Troup County-GA-1920,"Troup County, GA",1920,2019,2020,65,1816000,79,1537000,-14,279000,Gwinnett County,Gwinnett County-Troup County-GA
4176,Gwinnett County-Rutherford County-TN-1920,"Rutherford County, TN",1920,2019,2020,62,1405000,58,2020000,4,-615000,Gwinnett County,Gwinnett County-Rutherford County-TN
4177,Gwinnett County-Virginia Beach city-VA-1920,"Virginia Beach city, VA",1920,2019,2020,60,1837000,45,1091000,15,746000,Gwinnett County,Gwinnett County-Virginia Beach city-VA
4178,Gwinnett County-Lumpkin County-GA-1920,"Lumpkin County, GA",1920,2019,2020,49,1378000,105,3284000,-56,-1906000,Gwinnett County,Gwinnett County-Lumpkin County-GA
4179,Gwinnett County-Erie County-NY-1920,"Erie County, NY",1920,2019,2020,92,1774000,40,1015000,52,759000,Gwinnett County,Gwinnett County-Erie County-NY
4180,Gwinnett County-Sacramento County-CA-1920,"Sacramento County, CA",1920,2019,2020,78,1883000,50,855000,28,1028000,Gwinnett County,Gwinnett County-Sacramento County-CA
4181,Gwinnett County-Bartow County-GA-1920,"Bartow County, GA",1920,2019,2020,70,1698000,77,1307000,-7,391000,Gwinnett County,Gwinnett County-Bartow County-GA
4182,Gwinnett County-Spalding County-GA-1920,"Spalding County, GA",1920,2019,2020,67,1065000,100,1999000,-33,-934000,Gwinnett County,Gwinnett County-Spalding County-GA
4183,Gwinnett County-Jefferson County-KY-1920,"Jefferson County, KY",1920,2019,2020,52,1332000,69,2138000,-17,-806000,Gwinnett County,Gwinnett County-Jefferson County-KY
4184,Gwinnett County-Baltimore city-MD-1920,"Baltimore city, MD",1920,2019,2020,59,1027000,44,669000,15,358000,Gwinnett County,Gwinnett County-Baltimore city-MD
4185,Gwinnett County-Macomb County-MI-1920,"Macomb County, MI",1920,2019,2020,74,1817000,42,988000,32,829000,Gwinnett County,Gwinnett County-Macomb County-MI
4186,Gwinnett County-Hennepin County-MN-1920,"Hennepin County, MN",1920,2019,2020,74,1582000,67,1215000,7,367000,Gwinnett County,Gwinnett County-Hennepin County-MN
4187,Gwinnett County-Allegheny County-PA-1920,"Allegheny County, PA",1920,2019,2020,77,1956000,105,2896000,-28,-940000,Gwinnett County,Gwinnett County-Allegheny County-PA
4188,Gwinnett County-Osceola County-FL-1920,"Osceola County, FL",1920,2019,2020,60,1157000,89,2240000,-29,-1083000,Gwinnett County,Gwinnett County-Osceola County-FL
4189,Gwinnett County-Brevard County-FL-1920,"Brevard County, FL",1920,2019,2020,56,1098000,116,3942000,-60,-2844000,Gwinnett County,Gwinnett County-Brevard County-FL
4190,Gwinnett County-Escambia County-FL-1920,"Escambia County, FL",1920,2019,2020,56,1383000,88,2937000,-32,-1554000,Gwinnett County,Gwinnett County-Escambia County-FL
4191,Gwinnett County-Forsyth County-NC-1920,"Forsyth County, NC",1920,2019,2020,55,2355000,40,1116000,15,1239000,Gwinnett County,Gwinnett County-Forsyth County-NC
4192,Gwinnett County-Manatee County-FL-1920,"Manatee County, FL",1920,2019,2020,54,1557000,102,4484000,-48,-2927000,Gwinnett County,Gwinnett County-Manatee County-FL
4193,Gwinnett County-Hamilton County-OH-1920,"Hamilton County, OH",1920,2019,2020,48,1041000,56,1610000,-8,-569000,Gwinnett County,Gwinnett County-Hamilton County-OH
4194,Gwinnett County-Denton County-TX-1920,"Denton County, TX",1920,2019,2020,71,2144000,100,3586000,-29,-1442000,Gwinnett County,Gwinnett County-Denton County-TX
4195,Gwinnett County-Stephens County-GA-1920,"Stephens County, GA",1920,2019,2020,45,710000,74,2334000,-29,-1624000,Gwinnett County,Gwinnett County-Stephens County-GA
4196,Gwinnett County-Montgomery County-TN-1920,"Montgomery County, TN",1920,2019,2020,65,1287000,50,1182000,15,105000,Gwinnett County,Gwinnett County-Montgomery County-TN
4197,Gwinnett County-Denver County-CO-1920,"Denver County, CO",1920,2019,2020,51,1051000,40,1707000,11,-656000,Gwinnett County,Gwinnett County-Denver County-CO
4198,Gwinnett County-Pasco County-FL-1920,"Pasco County, FL",1920,2019,2020,66,1398000,94,3145000,-28,-1747000,Gwinnett County,Gwinnett County-Pasco County-FL
4199,Gwinnett County-Baldwin County-GA-1920,"Baldwin County, GA",1920,2019,2020,46,1018000,43,1524000,3,-506000,Gwinnett County,Gwinnett County-Baldwin County-GA
4200,Gwinnett County-Jefferson Parish-LA-1920,"Jefferson Parish, LA",1920,2019,2020,47,952000,34,835000,13,117000,Gwinnett County,Gwinnett County-Jefferson Parish-LA
4201,Gwinnett County-Beaufort County-SC-1920,"Beaufort County, SC",1920,2019,2020,40,943000,101,8609000,-61,-7666000,Gwinnett County,Gwinnett County-Beaufort County-SC
4202,Gwinnett County-Pierce County-WA-1920,"Pierce County, WA",1920,2019,2020,68,1591000,57,1358000,11,233000,Gwinnett County,Gwinnett County-Pierce County-WA
4203,Gwinnett County-Lake County-FL-1920,"Lake County, FL",1920,2019,2020,45,968000,76,2395000,-31,-1427000,Gwinnett County,Gwinnett County-Lake County-FL
4204,Gwinnett County-Sarasota County-FL-1920,"Sarasota County, FL",1920,2019,2020,49,1124000,73,3589000,-24,-2465000,Gwinnett County,Gwinnett County-Sarasota County-FL
4205,Gwinnett County-Glynn County-GA-1920,"Glynn County, GA",1920,2019,2020,44,1484000,108,5945000,-64,-4461000,Gwinnett County,Gwinnett County-Glynn County-GA
4206,Gwinnett County-Buncombe County-NC-1920,"Buncombe County, NC",1920,2019,2020,31,906000,41,1696000,-10,-790000,Gwinnett County,Gwinnett County-Buncombe County-NC
4207,Gwinnett County-Durham County-NC-1920,"Durham County, NC",1920,2019,2020,32,611000,42,973000,-10,-362000,Gwinnett County,Gwinnett County-Durham County-NC
4208,Gwinnett County-Oklahoma County-OK-1920,"Oklahoma County, OK",1920,2019,2020,43,1318000,54,1318000,-11,0,Gwinnett County,Gwinnett County-Oklahoma County-OK
4209,Gwinnett County-Fort Bend County-TX-1920,"Fort Bend County, TX",1920,2019,2020,60,1508000,95,3379000,-35,-1871000,Gwinnett County,Gwinnett County-Fort Bend County-TX
4210,Gwinnett County-Anne Arundel County-MD-1920,"Anne Arundel County, MD",1920,2019,2020,51,1442000,49,1033000,2,409000,Gwinnett County,Gwinnett County-Anne Arundel County-MD
4211,Gwinnett County-Salt Lake County-UT-1920,"Salt Lake County, UT",1920,2019,2020,43,1196000,34,1010000,9,186000,Gwinnett County,Gwinnett County-Salt Lake County-UT
4212,Gwinnett County-St. Lucie County-FL-1920,"St. Lucie County, FL",1920,2019,2020,36,874000,64,2093000,-28,-1219000,Gwinnett County,Gwinnett County-St. Lucie County-FL
4213,Gwinnett County-Lexington County-SC-1920,"Lexington County, SC",1920,2019,2020,37,1185000,78,3011000,-41,-1826000,Gwinnett County,Gwinnett County-Lexington County-SC
4214,Gwinnett County-El Paso County-TX-1920,"El Paso County, TX",1920,2019,2020,40,1194000,40,711000,0,483000,Gwinnett County,Gwinnett County-El Paso County-TX
4215,Gwinnett County-Anderson County-SC-1920,"Anderson County, SC",1920,2019,2020,38,1277000,66,5195000,-28,-3918000,Gwinnett County,Gwinnett County-Anderson County-SC
4216,Gwinnett County-Horry County-SC-1920,"Horry County, SC",1920,2019,2020,28,646000,53,2182000,-25,-1536000,Gwinnett County,Gwinnett County-Horry County-SC
4218,Henry County-Clayton County-GA-1920,"Clayton County, GA",1920,2019,2020,5158,89500000,2897,46331000,2261,43169000,Henry County,Henry County-Clayton County-GA
4219,Henry County-DeKalb County-GA-1920,"DeKalb County, GA",1920,2019,2020,2133,44536000,1024,21667000,1109,22869000,Henry County,Henry County-DeKalb County-GA
4220,Henry County-Fulton County-GA-1920,"Fulton County, GA",1920,2019,2020,1738,42610000,1332,35376000,406,7234000,Henry County,Henry County-Fulton County-GA
4221,Henry County-Spalding County-GA-1920,"Spalding County, GA",1920,2019,2020,787,20705000,1018,26368000,-231,-5663000,Henry County,Henry County-Spalding County-GA
4222,Henry County-Gwinnett County-GA-1920,"Gwinnett County, GA",1920,2019,2020,714,17043000,688,14558000,26,2485000,Henry County,Henry County-Gwinnett County-GA
4223,Henry County-Cobb County-GA-1920,"Cobb County, GA",1920,2019,2020,537,14564000,500,16996000,37,-2432000,Henry County,Henry County-Cobb County-GA
4224,Henry County-Newton County-GA-1920,"Newton County, GA",1920,2019,2020,544,9698000,548,12380000,-4,-2682000,Henry County,Henry County-Newton County-GA
4225,Henry County-Rockdale County-GA-1920,"Rockdale County, GA",1920,2019,2020,495,10672000,390,8883000,105,1789000,Henry County,Henry County-Rockdale County-GA
4226,Henry County-Butts County-GA-1920,"Butts County, GA",1920,2019,2020,398,7695000,681,-26373000,-283,34068000,Henry County,Henry County-Butts County-GA
4227,Henry County-Fayette County-GA-1920,"Fayette County, GA",1920,2019,2020,339,8048000,525,16316000,-186,-8268000,Henry County,Henry County-Fayette County-GA
4228,Henry County-Broward County-FL-1920,"Broward County, FL",1920,2019,2020,218,5138000,94,2096000,124,3042000,Henry County,Henry County-Broward County-FL
4229,Henry County-Bibb County-GA-1920,"Bibb County, GA",1920,2019,2020,204,4398000,155,2408000,49,1990000,Henry County,Henry County-Bibb County-GA
4230,Henry County-Coweta County-GA-1920,"Coweta County, GA",1920,2019,2020,162,4719000,429,13390000,-267,-8671000,Henry County,Henry County-Coweta County-GA
4231,Henry County-Douglas County-GA-1920,"Douglas County, GA",1920,2019,2020,165,3324000,126,2298000,39,1026000,Henry County,Henry County-Douglas County-GA
4232,Henry County-Houston County-GA-1920,"Houston County, GA",1920,2019,2020,146,3119000,142,5077000,4,-1958000,Henry County,Henry County-Houston County-GA
4233,Henry County-Queens County-NY-1920,"Queens County, NY",1920,2019,2020,116,2801000,37,852000,79,1949000,Henry County,Henry County-Queens County-NY
4234,Henry County-Orange County-FL-1920,"Orange County, FL",1920,2019,2020,132,2522000,64,1673000,68,849000,Henry County,Henry County-Orange County-FL
4235,Henry County-Chatham County-GA-1920,"Chatham County, GA",1920,2019,2020,96,1934000,80,2376000,16,-442000,Henry County,Henry County-Chatham County-GA
4236,Henry County-Cook County-IL-1920,"Cook County, IL",1920,2019,2020,109,2432000,67,1155000,42,1277000,Henry County,Henry County-Cook County-IL
4237,Henry County-Los Angeles County-CA-1920,"Los Angeles County, CA",1920,2019,2020,102,2156000,40,934000,62,1222000,Henry County,Henry County-Los Angeles County-CA
4238,Henry County-Muscogee County-GA-1920,"Muscogee County, GA",1920,2019,2020,125,1706000,75,1285000,50,421000,Henry County,Henry County-Muscogee County-GA
4239,Henry County-Lamar County-GA-1920,"Lamar County, GA",1920,2019,2020,107,2143000,252,7963000,-145,-5820000,Henry County,Henry County-Lamar County-GA
4240,Henry County-Palm Beach County-FL-1920,"Palm Beach County, FL",1920,2019,2020,76,1296000,41,1008000,35,288000,Henry County,Henry County-Palm Beach County-FL
4241,Henry County-Walton County-GA-1920,"Walton County, GA",1920,2019,2020,73,1655000,103,3812000,-30,-2157000,Henry County,Henry County-Walton County-GA
4242,Henry County-Pike County-GA-1920,"Pike County, GA",1920,2019,2020,68,1521000,263,7739000,-195,-6218000,Henry County,Henry County-Pike County-GA
4243,Henry County-Hillsborough County-FL-1920,"Hillsborough County, FL",1920,2019,2020,57,1225000,85,2633000,-28,-1408000,Henry County,Henry County-Hillsborough County-FL
4244,Henry County-Lowndes County-GA-1920,"Lowndes County, GA",1920,2019,2020,71,907000,41,531000,30,376000,Henry County,Henry County-Lowndes County-GA
4245,Henry County-Cherokee County-GA-1920,"Cherokee County, GA",1920,2019,2020,67,1795000,151,7595000,-84,-5800000,Henry County,Henry County-Cherokee County-GA
4246,Henry County-Duval County-FL-1920,"Duval County, FL",1920,2019,2020,67,1071000,54,1467000,13,-396000,Henry County,Henry County-Duval County-FL
4247,Henry County-Paulding County-GA-1920,"Paulding County, GA",1920,2019,2020,65,1361000,89,2437000,-24,-1076000,Henry County,Henry County-Paulding County-GA
4248,Henry County-Harris County-TX-1920,"Harris County, TX",1920,2019,2020,63,1256000,49,846000,14,410000,Henry County,Henry County-Harris County-TX
4249,Henry County-Monroe County-GA-1920,"Monroe County, GA",1920,2019,2020,54,1280000,287,10998000,-233,-9718000,Henry County,Henry County-Monroe County-GA
4250,Henry County-Mecklenburg County-NC-1920,"Mecklenburg County, NC",1920,2019,2020,65,1994000,53,1252000,12,742000,Henry County,Henry County-Mecklenburg County-NC
4251,Henry County-Richmond County-GA-1920,"Richmond County, GA",1920,2019,2020,53,959000,50,1145000,3,-186000,Henry County,Henry County-Richmond County-GA
4252,Henry County-Jasper County-GA-1920,"Jasper County, GA",1920,2019,2020,45,1241000,194,5934000,-149,-4693000,Henry County,Henry County-Jasper County-GA
4253,Henry County-Carroll County-GA-1920,"Carroll County, GA",1920,2019,2020,52,712000,77,1575000,-25,-863000,Henry County,Henry County-Carroll County-GA
4254,Henry County-Jefferson County-AL-1920,"Jefferson County, AL",1920,2019,2020,47,605000,46,1074000,1,-469000,Henry County,Henry County-Jefferson County-AL
4255,Henry County-Forsyth County-GA-1920,"Forsyth County, GA",1920,2019,2020,49,1813000,120,6096000,-71,-4283000,Henry County,Henry County-Forsyth County-GA
4256,Henry County-Pinellas County-FL-1920,"Pinellas County, FL",1920,2019,2020,45,1106000,38,1581000,7,-475000,Henry County,Henry County-Pinellas County-FL
4258,Rockdale County-DeKalb County-GA-1920,"DeKalb County, GA",1920,2019,2020,2151,42441000,1312,23510000,839,18931000,Rockdale County,Rockdale County-DeKalb County-GA
4259,Rockdale County-Newton County-GA-1920,"Newton County, GA",1920,2019,2020,1424,22940000,1962,34127000,-538,-11187000,Rockdale County,Rockdale County-Newton County-GA
4260,Rockdale County-Gwinnett County-GA-1920,"Gwinnett County, GA",1920,2019,2020,819,15221000,644,13296000,175,1925000,Rockdale County,Rockdale County-Gwinnett County-GA
4261,Rockdale County-Fulton County-GA-1920,"Fulton County, GA",1920,2019,2020,482,9399000,385,8548000,97,851000,Rockdale County,Rockdale County-Fulton County-GA
4262,Rockdale County-Henry County-GA-1920,"Henry County, GA",1920,2019,2020,390,8883000,495,10672000,-105,-1789000,Rockdale County,Rockdale County-Henry County-GA
4263,Rockdale County-Clayton County-GA-1920,"Clayton County, GA",1920,2019,2020,311,4729000,264,3571000,47,1158000,Rockdale County,Rockdale County-Clayton County-GA
4264,Rockdale County-Cobb County-GA-1920,"Cobb County, GA",1920,2019,2020,199,4544000,171,3169000,28,1375000,Rockdale County,Rockdale County-Cobb County-GA
4265,Rockdale County-Walton County-GA-1920,"Walton County, GA",1920,2019,2020,224,4751000,313,9002000,-89,-4251000,Rockdale County,Rockdale County-Walton County-GA
4266,Rockdale County-Kings County-NY-1920,"Kings County, NY",1920,2019,2020,65,1921000,41,628000,24,1293000,Rockdale County,Rockdale County-Kings County-NY
4267,Rockdale County-Broward County-FL-1920,"Broward County, FL",1920,2019,2020,59,1310000,42,767000,17,543000,Rockdale County,Rockdale County-Broward County-FL
4268,Rockdale County-Douglas County-GA-1920,"Douglas County, GA",1920,2019,2020,47,959000,47,867000,0,92000,Rockdale County,Rockdale County-Douglas County-GA
4269,Rockdale County-Clarke County-GA-1920,"Clarke County, GA",1920,2019,2020,45,907000,47,1818000,-2,-911000,Rockdale County,Rockdale County-Clarke County-GA
